STATE CODE,DISTRICT CODE,INDIA/STATE/UT/DISTRICT,TRU,P_Persons ,P_Males,P_Females,L_Persons,L_Males,L_Females,PL_Persons,PL_Males,PL_Females
0,0,INDIA,Total,1210193422,623724248,586469174,778454120,444203762,334250358,64,71,57
0,0,INDIA,Rural,833087662,427917052,405170610,493020878,288047480,204973398,59,67,51
0,0,INDIA,Urban,377105760,195807196,181298564,285433242,156156282,129276960,76,80,71
1,0,JAMMU & KASHMIR,Total,12548926,6665561,5883365,7245053,4370604,2874449,58,66,49
1,0,JAMMU & KASHMIR,Rural,9134820,4809619,4325201,4898008,2983896,1914112,54,62,44
1,0,JAMMU & KASHMIR,Urban,3414106,1855942,1558164,2347045,1386708,960337,69,75,62
1,1,Kupwara,Total,875564,475126,400438,454076,284397,169679,52,60,42
1,1,Kupwara,Rural,776322,418370,357952,393975,245342,148633,51,59,42
1,1,Kupwara,Urban,99242,56756,42486,60101,39055,21046,61,69,50
1,2,Badgam,Total,755331,400583,354748,350707,216720,133987,46,54,38
1,2,Badgam,Rural,666620,354419,312201,299932,186685,113247,45,53,36
1,2,Badgam,Urban,88711,46164,42547,50775,30035,20740,57,65,49
1,3,Leh(Ladakh),Total,147104,92907,54197,108885,77619,31266,74,84,58
1,3,Leh(Ladakh),Rural,83901,44605,39296,53868,32724,21144,64,73,54
1,3,Leh(Ladakh),Urban,63203,48302,14901,55017,44895,10122,87,93,68
1,4,Kargil,Total,143388,80791,62597,91604,61123,30481,64,76,49
1,4,Kargil,Rural,130635,74130,56505,82582,55680,26902,63,75,48
1,4,Kargil,Urban,12753,6661,6092,9022,5443,3579,71,82,59
1,5,Punch,Total,476820,252240,224580,269744,168435,101309,57,67,45
1,5,Punch,Rural,438176,230087,208089,239227,149524,89703,55,65,43
1,5,Punch,Urban,38644,22153,16491,30517,18911,11606,79,85,70
1,6,Rajouri,Total,619266,332424,286842,343196,210006,133190,55,63,46
1,6,Rajouri,Rural,575332,305253,270079,307501,186441,121060,53,61,45
1,6,Rajouri,Urban,43934,27171,16763,35695,23565,12130,81,87,72
1,7,Kathua,Total,615711,327953,287758,393611,231417,162194,64,71,56
1,7,Kathua,Rural,527176,280639,246537,324997,192840,132157,62,69,54
1,7,Kathua,Urban,88535,47314,41221,68614,38577,30037,77,82,73
1,8,Baramula,Total,1015503,542171,473332,571348,352289,219059,56,65,46
1,8,Baramula,Rural,840948,448357,392591,454730,283211,171519,54,63,44
1,8,Baramula,Urban,174555,93814,80741,116618,69078,47540,67,74,59
1,9,Bandipore,Total,385099,201531,183568,187789,116070,71719,49,58,39
1,9,Bandipore,Rural,320070,166445,153625,148807,91711,57096,46,55,37
1,9,Bandipore,Urban,65029,35086,29943,38982,24359,14623,60,69,49
1,10,Srinagar,Total,1250173,665789,584384,780729,455053,325676,62,68,56
1,10,Srinagar,Rural,15928,8220,7708,7620,4645,2975,48,57,39
1,10,Srinagar,Urban,1234245,657569,576676,773109,450408,322701,63,68,56
1,11,Ganderbal,Total,297003,158900,138103,147835,93222,54613,50,59,40
1,11,Ganderbal,Rural,250203,134064,116139,121559,77395,44164,49,58,38
1,11,Ganderbal,Urban,46800,24836,21964,26276,15827,10449,56,64,48
1,12,Pulwama,Total,570060,297988,272072,307088,184609,122479,54,62,45
1,12,Pulwama,Rural,491370,254609,236761,258048,154250,103798,53,61,44
1,12,Pulwama,Urban,78690,43379,35311,49040,30359,18681,62,70,53
1,13,Shupiyan,Total,265960,136302,129658,141038,82587,58451,53,61,45
1,13,Shupiyan,Rural,251010,128341,122669,130771,76637,54134,52,60,44
1,13,Shupiyan,Urban,14950,7961,6989,10267,5950,4317,69,75,62
1,14,Anantnag,Total,1069749,552203,517546,555453,325868,229585,52,59,44
1,14,Anantnag,Rural,791237,407278,383959,384704,227325,157379,49,56,41
1,14,Anantnag,Urban,278512,144925,133587,170749,98543,72206,61,68,54
1,15,Kulgam,Total,423181,216873,206308,212848,126668,86180,50,58,42
1,15,Kulgam,Rural,343739,175880,167859,167121,99687,67434,49,57,40
1,15,Kulgam,Urban,79442,40993,38449,45727,26981,18746,58,66,49
1,16,Doda,Total,409576,213091,196485,223343,141684,81659,55,66,42
1,16,Doda,Rural,377003,195065,181938,198296,126675,71621,53,65,39
1,16,Doda,Urban,32573,18026,14547,25047,15009,10038,77,83,69
1,17,Ramban,Total,283313,149032,134281,130054,86852,43202,46,58,32
1,17,Ramban,Rural,271527,142251,129276,121023,81165,39858,45,57,31
1,17,Ramban,Urban,11786,6781,5005,9031,5687,3344,77,84,67
1,18,Kishtwar,Total,231037,120496,110541,112348,71847,40501,49,60,37
1,18,Kishtwar,Rural,216196,112312,103884,100859,64970,35889,47,58,35
1,18,Kishtwar,Urban,14841,8184,6657,11489,6877,4612,77,84,69
1,19,Udhampur,Total,555357,298094,257263,330421,203248,127173,59,68,49
1,19,Udhampur,Rural,445850,232694,213156,242053,147261,94792,54,63,44
1,19,Udhampur,Urban,109507,65400,44107,88368,55987,32381,81,86,73
1,20,Reasi,Total,314714,166392,148322,153839,96036,57803,49,58,39
1,20,Reasi,Rural,288010,151716,136294,134788,84773,50015,47,56,37
1,20,Reasi,Urban,26704,14676,12028,19051,11263,7788,71,77,65
1,21,Jammu,Total,1526406,815727,710679,1147663,652302,495361,75,80,70
1,21,Jammu,Rural,768577,405740,362837,536949,307607,229342,70,76,63
1,21,Jammu,Urban,757829,409987,347842,610714,344695,266019,81,84,76
1,22,Samba,Total,318611,168948,149663,231434,132552,98882,73,78,66
1,22,Samba,Rural,264990,139144,125846,188598,107348,81250,71,77,65
1,22,Samba,Urban,53621,29804,23817,42836,25204,17632,80,85,74
2,0,HIMACHAL PRADESH,Total,6856509,3473892,3382617,5104506,2791542,2312964,74,80,68
2,0,HIMACHAL PRADESH,Rural,6167805,3102262,3065543,4533373,2475097,2058276,74,80,67
2,0,HIMACHAL PRADESH,Urban,688704,371630,317074,571133,316445,254688,83,85,80
2,1,Chamba,Total,518844,260848,257996,328940,189641,139299,63,73,54
2,1,Chamba,Rural,482653,241424,241229,298341,172529,125812,62,71,52
2,1,Chamba,Urban,36191,19424,16767,30599,17112,13487,85,88,80
2,2,Kangra,Total,1507223,748559,758664,1164461,613281,551180,77,82,73
2,2,Kangra,Rural,1420864,703276,717588,1097080,576989,520091,77,82,72
2,2,Kangra,Urban,86359,45283,41076,67381,36292,31089,78,80,76
2,3,Lahul & Spiti,Total,31528,16455,15073,22040,13018,9022,70,79,60
2,3,Lahul & Spiti,Rural,31528,16455,15073,22040,13018,9022,70,79,60
2,4,Kullu,Total,437474,224320,213154,310487,176552,133935,71,79,63
2,4,Kullu,Rural,396216,202418,193798,277004,157984,119020,70,78,61
2,4,Kullu,Urban,41258,21902,19356,33483,18568,14915,81,85,77
2,5,Mandi,Total,999518,496787,502731,736661,401990,334671,74,81,67
2,5,Mandi,Rural,936894,464732,472162,683751,374163,309588,73,81,66
2,5,Mandi,Urban,62624,32055,30569,52910,27827,25083,84,87,82
2,6,Hamirpur,Total,454293,216742,237551,361909,182350,179559,80,84,76
2,6,Hamirpur,Rural,422880,200450,222430,335205,168133,167072,79,84,75
2,6,Hamirpur,Urban,31413,16292,15121,26704,14217,12487,85,87,83
2,7,Una,Total,521057,263541,257516,403767,215575,188192,77,82,73
2,7,Una,Rural,476140,240088,236052,368700,196580,172120,77,82,73
2,7,Una,Urban,44917,23453,21464,35067,18995,16072,78,81,75
2,8,Bilaspur,Total,382056,192827,189229,291647,157835,133812,76,82,71
2,8,Bilaspur,Rural,356930,179726,177204,270766,146711,124055,76,82,70
2,8,Bilaspur,Urban,25126,13101,12025,20881,11124,9757,83,85,81
2,9,Solan,Total,576670,306162,270508,433877,247323,186554,75,81,69
2,9,Solan,Rural,474592,247195,227397,349800,197202,152598,74,80,67
2,9,Solan,Urban,102078,58967,43111,84077,50121,33956,82,85,79
2,10,Sirmaur,Total,530164,276801,253363,369651,209608,160043,70,76,63
2,10,Sirmaur,Rural,472926,246599,226327,322787,184197,138590,68,75,61
2,10,Sirmaur,Urban,57238,30202,27036,46864,25411,21453,82,84,79
2,11,Shimla,Total,813384,424486,388898,619427,347013,272414,76,82,70
2,11,Shimla,Rural,611884,313535,298349,446260,250235,196025,73,80,66
2,11,Shimla,Urban,201500,110951,90549,173167,96778,76389,86,87,84
2,12,Kinnaur,Total,84298,46364,37934,61639,37356,24283,73,81,64
2,12,Kinnaur,Rural,84298,46364,37934,61639,37356,24283,73,81,64
3,0,PUNJAB,Total,27704236,14634819,13069417,18988611,10626788,8361823,69,73,64
3,0,PUNJAB,Rural,17316800,9086466,8230334,11195395,6292022,4903373,65,69,60
3,0,PUNJAB,Urban,10387436,5548353,4839083,7793216,4334766,3458450,75,78,71
3,1,Gurdaspur,Total,2299026,1212995,1086031,1668339,928264,740075,73,77,68
3,1,Gurdaspur,Rural,1643882,858429,785453,1146337,634845,511492,70,74,65
3,1,Gurdaspur,Urban,655144,354566,300578,522002,293419,228583,80,83,76
3,2,Kapurthala,Total,817668,427659,390009,589324,324419,264905,72,76,68
3,2,Kapurthala,Rural,532296,275420,256876,368101,201969,166132,69,73,65
3,2,Kapurthala,Urban,285372,152239,133133,221223,122450,98773,78,80,74
3,3,Jalandhar,Total,2181753,1140536,1041217,1621845,884424,737421,74,78,71
3,3,Jalandhar,Rural,1021388,523390,497998,731501,396285,335216,72,76,67
3,3,Jalandhar,Urban,1160365,617146,543219,890344,488139,402205,77,79,74
3,4,Hoshiarpur,Total,1582793,806921,775872,1213407,647245,566162,77,80,73
3,4,Hoshiarpur,Rural,1247969,632251,615718,945773,503560,442213,76,80,72
3,4,Hoshiarpur,Urban,334824,174670,160154,267634,143685,123949,80,82,77
3,5,Shahid Bhagat Singh Nagar,Total,614362,314415,299947,444924,243152,201772,72,77,67
3,5,Shahid Bhagat Singh Nagar,Rural,488857,249182,239675,351798,192383,159415,72,77,67
3,5,Shahid Bhagat Singh Nagar,Urban,125505,65233,60272,93126,50769,42357,74,78,70
3,6,Fatehgarh Sahib,Total,599814,320603,279211,433038,243136,189902,72,76,68
3,6,Fatehgarh Sahib,Rural,414649,219831,194818,293446,164211,129235,71,75,66
3,6,Fatehgarh Sahib,Urban,185165,100772,84393,139592,78925,60667,75,78,72
3,7,Ludhiana,Total,3487882,1866203,1621679,2579209,1443283,1135926,74,77,70
3,7,Ludhiana,Rural,1425201,752685,672516,1017274,568137,449137,71,75,67
3,7,Ludhiana,Urban,2062681,1113518,949163,1561935,875146,686789,76,79,72
3,8,Moga,Total,992289,524289,468000,636979,353513,283466,64,67,61
3,8,Moga,Rural,768499,405793,362706,475967,265239,210728,62,65,58
3,8,Moga,Urban,223790,118496,105294,161012,88274,72738,72,74,69
3,9,Firozpur,Total,2026831,1070812,956019,1247177,721032,526145,62,67,55
3,9,Firozpur,Rural,1474592,775601,698991,854923,499493,355430,58,64,51
3,9,Firozpur,Urban,552239,295211,257028,392254,221539,170715,71,75,66
3,10,Muktsar,Total,902702,476300,426402,534782,306600,228182,59,64,54
3,10,Muktsar,Rural,650004,342495,307509,362451,209662,152789,56,61,50
3,10,Muktsar,Urban,252698,133805,118893,172331,96938,75393,68,72,63
3,11,Faridkot,Total,618008,327121,290887,389503,220815,168688,63,68,58
3,11,Faridkot,Rural,400494,211036,189458,235667,134011,101656,59,64,54
3,11,Faridkot,Urban,217514,116085,101429,153836,86804,67032,71,75,66
3,12,Bathinda,Total,1388859,744875,643984,865094,502066,363028,62,67,56
3,12,Bathinda,Rural,888943,475070,413873,505373,295879,209494,57,62,51
3,12,Bathinda,Urban,499916,269805,230111,359721,206187,153534,72,76,67
3,13,Mansa,Total,768808,408921,359887,431545,249388,182157,56,61,51
3,13,Mansa,Rural,605356,322466,282890,319248,186126,133122,53,58,47
3,13,Mansa,Urban,163452,86455,76997,112297,63262,49035,69,73,64
3,14,Patiala,Total,1892282,1002112,890170,1286836,725261,561575,68,72,63
3,14,Patiala,Rural,1130279,598239,532040,701885,402467,299418,62,67,56
3,14,Patiala,Urban,762003,403873,358130,584951,322794,262157,77,80,73
3,15,Amritsar ,Total,2490891,1322088,1168803,1717249,954526,762723,69,72,65
3,15,Amritsar ,Rural,1154831,608303,546528,701372,394098,307274,61,65,56
3,15,Amritsar ,Urban,1336060,713785,622275,1015877,560428,455449,76,79,73
3,16,Tarn Taran,Total,1120070,590239,529831,687511,391120,296391,61,66,56
3,16,Tarn Taran,Rural,978611,515291,463320,589090,336124,252966,60,65,55
3,16,Tarn Taran,Urban,141459,74948,66511,98421,54996,43425,70,73,65
3,17,Rupnagar,Total,683349,357265,326084,511149,284437,226712,75,80,70
3,17,Rupnagar,Rural,505529,263818,241711,371232,207850,163382,73,79,68
3,17,Rupnagar,Urban,177820,93447,84373,139917,76587,63330,79,82,75
3,18,Sahibzada Ajit Singh Nagar,Total,986147,524989,461158,744237,415249,328988,75,79,71
3,18,Sahibzada Ajit Singh Nagar,Rural,442112,236684,205428,313631,178839,134792,71,76,66
3,18,Sahibzada Ajit Singh Nagar,Urban,544035,288305,255730,430606,236410,194196,79,82,76
3,19,Sangrur,Total,1654408,878628,775780,1019011,581461,437550,62,66,56
3,19,Sangrur,Rural,1137633,604462,533171,670302,385152,285150,59,64,53
3,19,Sangrur,Urban,516775,274166,242609,348709,196309,152400,67,72,63
3,20,Barnala,Total,596294,317848,278446,367452,207397,160055,62,65,57
3,20,Barnala,Rural,405675,216020,189655,240024,135692,104332,59,63,55
3,20,Barnala,Urban,190619,101828,88791,127428,71705,55723,67,70,63
4,0,CHANDIGARH,Total,1054686,580282,474404,809653,468166,341487,77,81,72
4,0,CHANDIGARH,Rural,29004,17155,11849,20217,12890,7327,70,75,62
4,0,CHANDIGARH,Urban,1025682,563127,462555,789436,455276,334160,77,81,72
4,1,Chandigarh,Total,1054686,580282,474404,809653,468166,341487,77,81,72
4,1,Chandigarh,Rural,29004,17155,11849,20217,12890,7327,70,75,62
4,1,Chandigarh,Urban,1025682,563127,462555,789436,455276,334160,77,81,72
5,0,UTTARAKHAND,Total,10116752,5154178,4962574,6997433,3930174,3067259,69,76,62
5,0,UTTARAKHAND,Rural,7025583,3512456,3513127,4670901,2629745,2041156,66,75,58
5,0,UTTARAKHAND,Urban,3091169,1641722,1449447,2326532,1300429,1026103,75,79,71
5,1,Uttarkashi,Total,329686,168335,161351,216322,129289,87033,66,77,54
5,1,Uttarkashi,Rural,305469,155159,150310,197010,118064,78946,64,76,53
5,1,Uttarkashi,Urban,24217,13176,11041,19312,11225,8087,80,85,73
5,2,Chamoli,Total,391114,193572,197542,284118,157013,127105,73,81,64
5,2,Chamoli,Rural,332026,160205,171821,235363,128344,107019,71,80,62
5,2,Chamoli,Urban,59088,33367,25721,48755,28669,20086,83,86,78
5,3,Rudraprayag,Total,236857,111747,125110,169626,91016,78610,72,81,63
5,3,Rudraprayag,Rural,226939,105904,121035,161620,86062,75558,71,81,62
5,3,Rudraprayag,Urban,9918,5843,4075,8006,4954,3052,81,85,75
5,4,Tehri Garhwal,Total,616409,296604,319805,401040,227423,173617,65,77,54
5,4,Tehri Garhwal,Rural,546354,258038,288316,346248,195465,150783,63,76,52
5,4,Tehri Garhwal,Urban,70055,38566,31489,54792,31958,22834,78,83,73
5,5,Dehradun,Total,1698560,893222,805338,1280462,712934,567528,75,80,70
5,5,Dehradun,Rural,749000,389228,359772,521596,293348,228248,70,75,63
5,5,Dehradun,Urban,949560,503994,445566,758866,419586,339280,80,83,76
5,6,Garhwal,Total,686527,326406,360121,499212,263853,235359,73,81,65
5,6,Garhwal,Rural,573847,267575,306272,409434,215544,193890,71,81,63
5,6,Garhwal,Urban,112680,58831,53849,89778,48309,41469,80,82,77
5,7,Pithoragarh,Total,485993,240427,245566,350844,192237,158607,72,80,65
5,7,Pithoragarh,Rural,416430,204119,212311,294106,162148,131958,71,79,62
5,7,Pithoragarh,Urban,69563,36308,33255,56738,30089,26649,82,83,80
5,8,Bageshwar,Total,259840,124121,135719,181713,98693,83020,70,80,61
5,8,Bageshwar,Rural,250749,119402,131347,174289,94680,79609,70,79,61
5,8,Bageshwar,Urban,9091,4719,4372,7424,4013,3411,82,85,78
5,9,Almora,Total,621927,290414,331513,440918,233748,207170,71,80,62
5,9,Almora,Rural,559595,256679,302916,387124,203782,183342,69,79,61
5,9,Almora,Urban,62332,33735,28597,53794,29966,23828,86,89,83
5,10,Champawat,Total,259315,130881,128434,179844,103170,76674,69,79,60
5,10,Champawat,Rural,220970,110649,110321,151698,87399,64299,69,79,58
5,10,Champawat,Urban,38345,20232,18113,28146,15771,12375,73,78,68
5,11,Nainital,Total,955128,494115,461013,706750,391234,315516,74,79,68
5,11,Nainital,Rural,583237,299542,283695,424357,237751,186606,73,79,66
5,11,Nainital,Urban,371891,194573,177318,282393,153483,128910,76,79,73
5,12,Udham Singh Nagar,Total,1648367,858906,789461,1060739,611229,449510,64,71,57
5,12,Udham Singh Nagar,Rural,1061841,550311,511530,667970,387982,279988,63,71,55
5,12,Udham Singh Nagar,Urban,586526,308595,277931,392769,223247,169522,67,72,61
5,13,Hardwar,Total,1927029,1025428,901601,1225845,718335,507510,64,70,56
5,13,Hardwar,Rural,1199126,635645,563481,700086,419176,280910,58,66,50
5,13,Hardwar,Urban,727903,389783,338120,525759,299159,226600,72,77,67
6,0,HARYANA,Total,25353081,13505130,11847951,16904324,9991838,6912486,67,74,58
6,0,HARYANA,Rural,16531493,8791036,7740457,10393591,6294506,4099085,63,72,53
6,0,HARYANA,Urban,8821588,4714094,4107494,6510733,3697332,2813401,74,78,68
6,1,Panchkula,Total,558890,298919,259971,411964,233755,178209,74,78,69
6,1,Panchkula,Rural,252231,136008,116223,170276,100327,69949,68,74,60
6,1,Panchkula,Urban,306659,162911,143748,241688,133428,108260,79,82,75
6,2,Ambala,Total,1136784,604044,532740,839911,473924,365987,74,78,69
6,2,Ambala,Rural,632243,334564,297679,440275,252947,187328,70,76,63
6,2,Ambala,Urban,504541,269480,235061,399636,220977,178659,79,82,76
6,3,Yamunanagar,Total,1214162,646801,567361,845293,483416,361877,70,75,64
6,3,Yamunanagar,Rural,741370,394010,347360,486663,283036,203627,66,72,59
6,3,Yamunanagar,Urban,472792,252791,220001,358630,200380,158250,76,79,72
6,4,Kurukshetra,Total,964231,510370,453861,651122,373007,278115,68,73,61
6,4,Kurukshetra,Rural,685296,360790,324506,439359,253884,185475,64,70,57
6,4,Kurukshetra,Urban,278935,149580,129355,211763,119123,92640,76,80,72
6,5,Kaithal,Total,1072861,570595,502266,661627,393793,267834,62,69,53
6,5,Kaithal,Rural,837171,445614,391557,498452,300069,198383,60,67,51
6,5,Kaithal,Urban,235690,124981,110709,163175,93724,69451,69,75,63
6,6,Karnal,Total,1506323,798840,707483,1002772,579438,423334,67,73,60
6,6,Karnal,Rural,1050293,557305,492988,664012,390799,273213,63,70,55
6,6,Karnal,Urban,456030,241535,214495,338760,188639,150121,74,78,70
6,7,Panipat,Total,1202811,646324,556487,804056,475459,328597,67,74,59
6,7,Panipat,Rural,649866,349674,300192,412631,250016,162615,63,71,54
6,7,Panipat,Urban,552945,296650,256295,391425,225443,165982,71,76,65
6,8,Sonipat,Total,1480080,798948,681132,1044387,620373,424014,71,78,62
6,8,Sonipat,Rural,1028393,557103,471290,702898,425204,277694,68,76,59
6,8,Sonipat,Urban,451687,241845,209842,341489,195169,146320,76,81,70
6,9,Jind,Total,1332042,712254,619788,849110,513529,335581,64,72,54
6,9,Jind,Rural,1028119,550513,477606,630937,387289,243648,61,70,51
6,9,Jind,Urban,303923,161741,142182,218173,126240,91933,72,78,65
6,10,Fatehabad,Total,941522,494834,446688,568991,336319,232672,60,68,52
6,10,Fatehabad,Rural,762182,400587,361595,443559,266048,177511,58,66,49
6,10,Fatehabad,Urban,179340,94247,85093,125432,70271,55161,70,75,65
6,11,Sirsa,Total,1295114,683242,611872,803145,472131,331014,62,69,54
6,11,Sirsa,Rural,974624,514092,460532,573530,342722,230808,59,67,50
6,11,Sirsa,Urban,320490,169150,151340,229615,129409,100206,72,77,66
6,12,Hisar,Total,1742815,931535,811280,1121735,676662,445073,64,73,55
6,12,Hisar,Rural,1189789,634149,555640,729380,449452,279928,61,71,50
6,12,Hisar,Urban,553026,297386,255640,392355,227210,165145,71,76,65
6,13,Bhiwani,Total,1629109,864616,764493,1092058,657273,434785,67,76,57
6,13,Bhiwani,Rural,1306531,692944,613587,856035,521953,334082,66,75,54
6,13,Bhiwani,Urban,322578,171672,150906,236023,135320,100703,73,79,67
6,14,Rohtak,Total,1058683,566708,491975,750013,439697,310316,71,78,63
6,14,Rohtak,Rural,613864,330788,283076,419938,254746,165192,68,77,58
6,14,Rohtak,Urban,444819,235920,208899,330075,184951,145124,74,78,69
6,15,Jhajjar,Total,956907,514303,442604,679568,401442,278126,71,78,63
6,15,Jhajjar,Rural,713933,383887,330046,494462,295263,199199,69,77,60
6,15,Jhajjar,Urban,242974,130416,112558,185106,106179,78927,76,81,70
6,16,Mahendragarh,Total,921680,486553,435127,640238,387696,252542,69,80,58
6,16,Mahendragarh,Rural,788705,416217,372488,541911,331002,210909,69,80,57
6,16,Mahendragarh,Urban,132975,70336,62639,98327,56694,41633,74,81,66
6,17,Rewari,Total,896129,472254,423875,644611,380376,264235,72,81,62
6,17,Rewari,Rural,664718,348631,316087,470232,280335,189897,71,80,60
6,17,Rewari,Urban,231411,123623,107788,174379,100041,74338,75,81,69
6,18,Gurgaon,Total,1514085,817274,696811,1111508,639970,471538,73,78,68
6,18,Gurgaon,Rural,472085,251520,220565,329009,195928,133081,70,78,60
6,18,Gurgaon,Urban,1042000,565754,476246,782499,444042,338457,75,78,71
6,19,Mewat,Total,1089406,571480,517926,475074,323815,151259,44,57,29
6,19,Mewat,Rural,965389,506297,459092,402351,279619,122732,42,55,27
6,19,Mewat,Urban,124017,65183,58834,72723,44196,28527,59,68,48
6,20,Faridabad,Total,1798954,961532,837422,1296234,748564,547670,72,78,65
6,20,Faridabad,Rural,369861,197827,172034,236239,145942,90297,64,74,52
6,20,Faridabad,Urban,1429093,763705,665388,1059995,602622,457373,74,79,69
6,21,Palwal,Total,1040493,553704,486789,610907,381199,229708,59,69,47
6,21,Palwal,Rural,804830,428516,376314,451442,287925,163517,56,67,43
6,21,Palwal,Urban,235663,125188,110475,159465,93274,66191,68,75,60
7,0,NCT OF DELHI,Total,16753235,8976410,7776825,12763352,7210050,5553302,76,80,71
7,0,NCT OF DELHI,Rural,419319,227000,192319,300539,176628,123911,72,78,64
7,0,NCT OF DELHI,Urban,16333916,8749410,7584506,12462813,7033422,5429391,76,80,72
7,1,North West,Total,3651261,1960677,1690584,2715875,1546038,1169837,74,79,69
7,1,North West,Rural,213746,115760,97986,149432,88277,61155,70,76,62
7,1,North West,Urban,3437515,1844917,1592598,2566443,1457761,1108682,75,79,70
7,2,North,Total,883418,472260,411158,679294,380962,298332,77,81,73
7,2,North,Rural,17748,9540,8208,13027,7640,5387,73,80,66
7,2,North,Urban,865670,462720,402950,666267,373322,292945,77,81,73
7,3,North East,Total,2240749,1188307,1052442,1610128,910691,699437,72,77,66
7,3,North East,Rural,21542,11729,9813,14093,8183,5910,65,70,60
7,3,North East,Urban,2219207,1176578,1042629,1596035,902508,693527,72,77,67
7,4,East,Total,1707725,906721,801004,1347452,744715,602737,79,82,75
7,4,East,Rural,3530,1869,1661,3003,1608,1395,85,86,84
7,4,East,Urban,1704195,904852,799343,1344449,743107,601342,79,82,75
7,5,New Delhi,Total,133713,73846,59867,109195,63005,46190,82,85,77
7,5,New Delhi,Urban,133713,73846,59867,109195,63005,46190,82,85,77
7,6,Central,Total,578671,305926,272745,441824,240187,201637,76,79,74
7,6,Central,Urban,578671,305926,272745,441824,240187,201637,76,79,74
7,7,West,Total,2531583,1349685,1181898,1959256,1092507,866749,77,81,73
7,7,West,Rural,6423,3407,3016,4597,2669,1928,72,78,64
7,7,West,Urban,2525160,1346278,1178882,1954659,1089838,864821,77,81,73
7,8,South West,Total,2292363,1248700,1043663,1802505,1035011,767494,79,83,74
7,8,South West,Rural,144220,77676,66544,108155,63088,45067,75,81,68
7,8,South West,Urban,2148143,1171024,977119,1694350,971923,722427,79,83,74
7,9,South,Total,2733752,1470288,1263464,2097823,1196934,900889,77,81,71
7,9,South,Rural,12110,7019,5091,8232,5163,3069,68,74,60
7,9,South,Urban,2721642,1463269,1258373,2089591,1191771,897820,77,81,71
8,0,RAJASTHAN,Total,68621012,35620086,33000926,38970500,24184782,14785718,57,68,45
8,0,RAJASTHAN,Rural,51540236,26680882,24859354,26945543,17256780,9688763,52,65,39
8,0,RAJASTHAN,Urban,17080776,8939204,8141572,12024957,6928002,5096955,70,78,63
8,1,Ganganagar,Total,1969520,1043730,925790,1206320,719999,486321,61,69,53
8,1,Ganganagar,Rural,1433858,758529,675329,830379,503385,326994,58,66,48
8,1,Ganganagar,Urban,535662,285201,250461,375941,216614,159327,70,76,64
8,2,Hanumangarh,Total,1779650,933660,845990,1057534,637735,419799,59,68,50
8,2,Hanumangarh,Rural,1428884,749080,679804,815163,498991,316172,57,67,47
8,2,Hanumangarh,Urban,350766,184580,166186,242371,138744,103627,69,75,62
8,3,Bikaner,Total,2367745,1243916,1123829,1300806,797119,503687,55,64,45
8,3,Bikaner,Rural,1564009,822098,741911,752030,480895,271135,48,58,37
8,3,Bikaner,Urban,803736,421818,381918,548776,316224,232552,68,75,61
8,4,Churu,Total,2041172,1053375,987797,1165255,709852,455403,57,67,46
8,4,Churu,Rural,1464691,756279,708412,800983,494890,306093,55,65,43
8,4,Churu,Urban,576481,297096,279385,364272,214962,149310,63,72,53
8,5,Jhunjhunun,Total,2139658,1097390,1042268,1385546,827466,558080,65,75,54
8,5,Jhunjhunun,Rural,1649538,843536,806002,1056723,633920,422803,64,75,52
8,5,Jhunjhunun,Urban,490120,253854,236266,328823,193546,135277,67,76,57
8,6,Alwar,Total,3671999,1938929,1733070,2215988,1384399,831589,60,71,48
8,6,Alwar,Rural,3017711,1589143,1428568,1735107,1103790,631317,57,69,44
8,6,Alwar,Urban,654288,349786,304502,480881,280609,200272,73,80,66
8,7,Bharatpur,Total,2549121,1357896,1191225,1507274,965537,541737,59,71,45
8,7,Bharatpur,Rural,2054400,1095085,959315,1163838,762075,401763,57,70,42
8,7,Bharatpur,Urban,494721,262811,231910,343436,203462,139974,69,77,60
8,8,Dhaulpur,Total,1207293,654344,552949,695597,444051,251546,58,68,45
8,8,Dhaulpur,Rural,959673,521401,438272,540673,351186,189487,56,67,43
8,8,Dhaulpur,Urban,247620,132943,114677,154924,92865,62059,63,70,54
8,9,Karauli,Total,1458459,784943,673516,820829,543479,277350,56,69,41
8,9,Karauli,Rural,1239798,668812,570986,683492,459253,224239,55,69,39
8,9,Karauli,Urban,218661,116131,102530,137337,84226,53111,63,73,52
8,10,Sawai Madhopur,Total,1338114,706558,631556,754132,496340,257792,56,70,41
8,10,Sawai Madhopur,Rural,1071780,566817,504963,569264,386274,182990,53,68,36
8,10,Sawai Madhopur,Urban,266334,139741,126593,184868,110066,74802,69,79,59
8,11,Dausa,Total,1637226,859821,777405,954848,610152,344696,58,71,44
8,11,Dausa,Rural,1434533,753670,680863,811899,525642,286257,57,70,42
8,11,Dausa,Urban,202693,106151,96542,142949,84510,58439,71,80,61
8,12,Jaipur,Total,6663971,3490787,3173184,4395012,2617028,1777984,66,75,56
8,12,Jaipur,Rural,3164767,1648975,1515792,1840416,1165918,674498,58,71,44
8,12,Jaipur,Urban,3499204,1841812,1657392,2554596,1451110,1103486,73,79,67
8,13,Sikar,Total,2677737,1377120,1300617,1679913,1016609,663304,63,74,51
8,13,Sikar,Rural,2044437,1049331,995106,1260783,770776,490007,62,73,49
8,13,Sikar,Urban,633300,327789,305511,419130,245833,173297,66,75,57
8,14,Nagaur,Total,3309234,1698760,1610474,1801102,1131927,669175,54,67,42
8,14,Nagaur,Rural,2674804,1371733,1303071,1409728,899102,510626,53,66,39
8,14,Nagaur,Urban,634430,327027,307403,391374,232825,158549,62,71,52
8,15,Jodhpur,Total,3685681,1924326,1761355,2075029,1295900,779129,56,67,44
8,15,Jodhpur,Rural,2421621,1260206,1161415,1187942,786122,401820,49,62,35
8,15,Jodhpur,Urban,1264060,664120,599940,887087,509778,377309,70,77,63
8,16,Jaisalmer,Total,672008,363346,308662,314345,214540,99805,47,59,32
8,16,Jaisalmer,Rural,582798,313750,269048,254042,176726,77316,44,56,29
8,16,Jaisalmer,Urban,89210,49596,39614,60303,37814,22489,68,76,57
8,17,Barmer,Total,2604453,1370494,1233959,1210278,800983,409295,46,58,33
8,17,Barmer,Rural,2422037,1274070,1147967,1085931,726366,359565,45,57,31
8,17,Barmer,Urban,182416,96424,85992,124347,74617,49730,68,77,58
8,18,Jalor,Total,1830151,937918,892233,842793,554463,288330,46,59,32
8,18,Jalor,Rural,1678248,858833,819415,749421,496854,252567,45,58,31
8,18,Jalor,Urban,151903,79085,72818,93372,57609,35763,61,73,49
8,19,Sirohi,Total,1037185,535115,502070,484811,315813,168998,47,59,34
8,19,Sirohi,Rural,828375,424973,403402,339394,229024,110370,41,54,27
8,19,Sirohi,Urban,208810,110142,98668,145417,86789,58628,70,79,59
8,20,Pali,Total,2038533,1025895,1012638,1103704,680962,422742,54,66,42
8,20,Pali,Rural,1578682,787974,790708,796917,499262,297655,50,63,38
8,20,Pali,Urban,459851,237921,221930,306787,181700,125087,67,76,56
8,21,Ajmer,Total,2584913,1325911,1259002,1557264,946648,610616,60,71,49
8,21,Ajmer,Rural,1548574,790215,758359,782017,513974,268043,50,65,35
8,21,Ajmer,Urban,1036339,535696,500643,775247,432674,342573,75,81,68
8,22,Tonk,Total,1421711,729390,692321,762485,487290,275195,54,67,40
8,22,Tonk,Rural,1103868,569040,534828,556057,371395,184662,50,65,35
8,22,Tonk,Urban,317843,160350,157493,206428,115895,90533,65,72,57
8,23,Bundi,Total,1113725,579385,534340,595447,379208,216239,53,65,40
8,23,Bundi,Rural,891623,464347,427276,442391,290308,152083,50,63,36
8,23,Bundi,Urban,222102,115038,107064,153056,88900,64156,69,77,60
8,24,Bhilwara,Total,2410459,1224483,1185976,1288139,801308,486831,53,65,41
8,24,Bhilwara,Rural,1897292,957879,939413,918878,590075,328803,48,62,35
8,24,Bhilwara,Urban,513167,266604,246563,369261,211233,158028,72,79,64
8,25,Rajsamand,Total,1158283,582670,575613,629307,390192,239115,54,67,42
8,25,Rajsamand,Rural,973822,487758,486064,495343,313876,181467,51,64,37
8,25,Rajsamand,Urban,184461,94912,89549,133964,76316,57648,73,80,64
8,26,Dungarpur,Total,1388906,698069,690837,698541,427775,270766,50,61,39
8,26,Dungarpur,Rural,1300129,652478,647651,631398,390662,240736,49,60,37
8,26,Dungarpur,Urban,88777,45591,43186,67143,37113,30030,76,81,70
8,27,Banswara,Total,1798194,908755,889439,844722,525217,319505,47,58,36
8,27,Banswara,Rural,1670368,843391,826977,747562,472402,275160,45,56,33
8,27,Banswara,Urban,127826,65364,62462,97160,52815,44345,76,81,71
8,28,Chittaurgarh,Total,1544392,784054,760338,834517,523974,310543,54,67,41
8,28,Chittaurgarh,Rural,1259090,637086,622004,624945,405747,219198,50,64,35
8,28,Chittaurgarh,Urban,285302,146968,138334,209572,118227,91345,73,80,66
8,29,Kota,Total,1950491,1023153,927338,1318643,781253,537390,68,76,58
8,29,Kota,Rural,774286,401931,372355,464286,289724,174562,60,72,47
8,29,Kota,Urban,1176205,621222,554983,854357,491529,362828,73,79,65
8,30,Baran,Total,1223921,635495,588426,703695,439566,264129,57,69,45
8,30,Baran,Rural,969490,503368,466122,529159,337884,191275,55,67,41
8,30,Baran,Urban,254431,132127,122304,174536,101682,72854,69,77,60
8,31,Jhalawar,Total,1411327,725667,685660,750039,473018,277021,53,65,40
8,31,Jhalawar,Rural,1181889,606823,575066,586941,380164,206777,50,63,36
8,31,Jhalawar,Urban,229438,118844,110594,163098,92854,70244,71,78,64
8,32,Udaipur,Total,3067549,1566781,1500768,1611485,991989,619496,53,63,41
8,32,Udaipur,Rural,2458658,1250880,1207778,1131317,726927,404390,46,58,33
8,32,Udaipur,Urban,608891,315901,292990,480168,265062,215106,79,84,73
8,33,Pratapgarh,Total,868231,437950,430281,405100,252990,152110,47,58,35
8,33,Pratapgarh,Rural,796503,401391,395112,351124,223191,127933,44,56,32
8,33,Pratapgarh,Urban,71728,36559,35169,53976,29799,24177,75,82,69
9,0,UTTAR PRADESH,Total,199581477,104596415,94985062,118423805,70479196,47944609,59,67,50
9,0,UTTAR PRADESH,Rural,155111022,81044655,74066367,88396557,53609910,34786647,57,66,47
9,0,UTTAR PRADESH,Urban,44470455,23551760,20918695,30027248,16869286,13157962,68,72,63
9,1,Saharanpur,Total,3464228,1835740,1628488,2131213,1250343,880870,62,68,54
9,1,Saharanpur,Rural,2400420,1271091,1129329,1424121,852955,571166,59,67,51
9,1,Saharanpur,Urban,1063808,564649,499159,707092,397388,309704,66,70,62
9,2,Muzaffarnagar,Total,4138605,2194540,1944065,2459547,1467774,991773,59,67,51
9,2,Muzaffarnagar,Rural,2948529,1565711,1382818,1722171,1043386,678785,58,67,49
9,2,Muzaffarnagar,Urban,1190076,628829,561247,737376,424388,312988,62,67,56
9,3,Bijnor,Total,3683896,1925787,1758109,2207723,1284321,923402,60,67,53
9,3,Bijnor,Rural,2758262,1441894,1316368,1652896,977191,675705,60,68,51
9,3,Bijnor,Urban,925634,483893,441741,554827,307130,247697,60,63,56
9,4,Moradabad,Total,4773138,2508299,2264839,2352924,1409312,943612,49,56,42
9,4,Moradabad,Rural,3197475,1682789,1514686,1468628,916885,551743,46,54,36
9,4,Moradabad,Urban,1575663,825510,750153,884296,492427,391869,56,60,52
9,5,Rampur,Total,2335398,1226175,1109223,1082390,651902,430488,46,53,39
9,5,Rampur,Rural,1746637,918711,827926,789982,487814,302168,45,53,36
9,5,Rampur,Urban,588761,307464,281297,292408,164088,128320,50,53,46
9,6,Jyotiba Phule Nagar,Total,1838771,964319,874452,1016659,620584,396075,55,64,45
9,6,Jyotiba Phule Nagar,Rural,1382115,725817,656298,755726,472113,283613,55,65,43
9,6,Jyotiba Phule Nagar,Urban,456656,238502,218154,260933,148471,112462,57,62,52
9,7,Meerut,Total,3447405,1829192,1618213,2213483,1297767,915716,64,71,57
9,7,Meerut,Rural,1684832,896456,788376,1035699,627526,408173,61,70,52
9,7,Meerut,Urban,1762573,932736,829837,1177784,670241,507543,67,72,61
9,8,Baghpat,Total,1302156,700724,601432,818585,503134,315451,63,72,52
9,8,Baghpat,Rural,1028021,554613,473408,643480,399772,243708,63,72,51
9,8,Baghpat,Urban,274135,146111,128024,175105,103362,71743,64,71,56
9,9,Ghaziabad,Total,4661452,2481803,2179649,3398407,1871853,1526554,73,75,70
9,9,Ghaziabad,Rural,1516878,807690,709188,945431,573052,372379,62,71,53
9,9,Ghaziabad,Urban,3144574,1674113,1470461,2452976,1298801,1154175,78,78,78
9,10,Gautam Buddha Nagar,Total,1674714,904505,770209,1175053,696210,478843,70,77,62
9,10,Gautam Buddha Nagar,Rural,677304,360728,316576,438286,268432,169854,65,74,54
9,10,Gautam Buddha Nagar,Urban,997410,543777,453633,736767,427778,308989,74,79,68
9,11,Bulandshahr ,Total,3498507,1848643,1649864,2079372,1284839,794533,59,70,48
9,11,Bulandshahr ,Rural,2630716,1392425,1238291,1552573,977223,575350,59,70,46
9,11,Bulandshahr ,Urban,867791,456218,411573,526799,307616,219183,61,67,53
9,12,Aligarh,Total,3673849,1958536,1715313,2170634,1333310,837324,59,68,49
9,12,Aligarh,Rural,2457268,1312501,1144767,1435050,909529,525521,58,69,46
9,12,Aligarh,Urban,1216581,646035,570546,735584,423781,311803,60,66,55
9,13,Mahamaya Nagar,Total,1565678,837446,728232,968831,593806,375025,62,71,51
9,13,Mahamaya Nagar,Rural,1232081,660394,571687,757857,472057,285800,62,71,50
9,13,Mahamaya Nagar,Urban,333597,177052,156545,210974,121749,89225,63,69,57
9,14,Mathura,Total,2541894,1368445,1173449,1558397,975781,582616,61,71,50
9,14,Mathura,Rural,1788001,963330,824671,1061416,684931,376485,59,71,46
9,14,Mathura,Urban,753893,405115,348778,496981,290850,206131,66,72,59
9,15,Agra,Total,4380793,2356104,2024689,2598427,1572552,1025875,59,67,51
9,15,Agra,Rural,2371296,1273883,1097413,1445417,907307,538110,61,71,49
9,15,Agra,Urban,2009497,1082221,927276,1153010,665245,487765,57,61,53
9,16,Firozabad,Total,2496761,1337141,1159620,1586618,947258,639360,64,71,55
9,16,Firozabad,Rural,1664491,894490,770001,1053720,645148,408572,63,72,53
9,16,Firozabad,Urban,832270,442651,389619,532898,302110,230788,64,68,59
9,17,Mainpuri,Total,1847194,984892,862302,1229884,728559,501325,67,74,58
9,17,Mainpuri,Rural,1562861,835567,727294,1028777,617230,411547,66,74,57
9,17,Mainpuri,Urban,284333,149325,135008,201107,111329,89778,71,75,66
9,18,Budaun,Total,3712738,1997242,1715496,1621808,1033641,588167,44,52,34
9,18,Budaun,Rural,3067803,1658303,1409500,1284550,838250,446300,42,51,32
9,18,Budaun,Urban,644935,338939,305996,337258,195391,141867,52,58,46
9,19,Bareilly,Total,4465344,2371454,2093890,2297158,1402668,894490,51,59,43
9,19,Bareilly,Rural,2902849,1543207,1359642,1406517,889407,517110,48,58,38
9,19,Bareilly,Urban,1562495,828247,734248,890641,513261,377380,57,62,51
9,20,Pilibhit,Total,2037225,1078525,958700,1106429,677987,428442,54,63,45
9,20,Pilibhit,Rural,1682069,890894,791175,897150,557897,339253,53,63,43
9,20,Pilibhit,Urban,355156,187631,167525,209279,120090,89189,59,64,53
9,21,Shahjahanpur,Total,3002376,1610182,1392194,1548811,948463,600348,52,59,43
9,21,Shahjahanpur,Rural,2410968,1297546,1113422,1205009,753122,451887,50,58,41
9,21,Shahjahanpur,Urban,591408,312636,278772,343802,195341,148461,58,62,53
9,22,Kheri,Total,4013634,2126782,1886852,2112755,1282925,829830,53,60,44
9,22,Kheri,Rural,3552289,1883534,1668755,1817218,1117061,700157,51,59,42
9,22,Kheri,Urban,461345,243248,218097,295537,165864,129673,64,68,59
9,23,Sitapur,Total,4474446,2380666,2093780,2371557,1451506,920051,53,61,44
9,23,Sitapur,Rural,3944454,2102249,1842205,2029452,1261875,767577,51,60,42
9,23,Sitapur,Urban,529992,278417,251575,342105,189631,152474,65,68,61
9,24,Hardoi,Total,4091380,2204264,1887116,2361960,1427019,934941,58,65,50
9,24,Hardoi,Rural,3550389,1918232,1632157,2013550,1228416,785134,57,64,48
9,24,Hardoi,Urban,540991,286032,254959,348410,198603,149807,64,69,59
9,25,Unnao,Total,3110595,1636295,1474300,1839433,1092942,746491,59,67,51
9,25,Unnao,Rural,2577332,1355759,1221573,1475590,889869,585721,57,66,48
9,25,Unnao,Urban,533263,280536,252727,363843,203073,160770,68,72,64
9,26,Lucknow,Total,4588455,2407897,2180558,3226214,1799177,1427037,70,75,65
9,26,Lucknow,Rural,1550737,817350,733387,929964,550830,379134,60,67,52
9,26,Lucknow,Urban,3037718,1590547,1447171,2296250,1248347,1047903,76,78,72
9,27,Rae Bareli,Total,3404004,1753344,1650660,2031876,1202304,829572,60,69,50
9,27,Rae Bareli,Rural,3096097,1593143,1502954,1809963,1079504,730459,58,68,49
9,27,Rae Bareli,Urban,307907,160201,147706,221913,122800,99113,72,77,67
9,28,Farrukhabad,Total,1887577,1007479,880098,1125457,676067,449390,60,67,51
9,28,Farrukhabad,Rural,1472283,786658,685625,853420,522003,331417,58,66,48
9,28,Farrukhabad,Urban,415294,220821,194473,272037,154064,117973,66,70,61
9,29,Kannauj,Total,1658005,882546,775459,1040874,617700,423174,63,70,55
9,29,Kannauj,Rural,1377419,735022,642397,867036,519079,347957,63,71,54
9,29,Kannauj,Urban,280586,147524,133062,173838,98621,75217,62,67,57
9,30,Etawah,Total,1579160,845893,733267,1087004,638158,448846,69,75,61
9,30,Etawah,Rural,1212850,652350,560500,817698,488644,329054,67,75,59
9,30,Etawah,Urban,366310,193543,172767,269306,149514,119792,74,77,69
9,31,Auraiya,Total,1372287,736144,636143,945614,553702,391912,69,75,62
9,31,Auraiya,Rural,1138082,612399,525683,768642,455546,313096,68,74,60
9,31,Auraiya,Urban,234205,123745,110460,176972,98156,78816,76,79,71
9,32,Kanpur Dehat,Total,1795092,964284,830808,1202516,712500,490016,67,74,59
9,32,Kanpur Dehat,Rural,1621654,872373,749281,1078654,643030,435624,67,74,58
9,32,Kanpur Dehat,Urban,173438,91911,81527,123862,69470,54392,71,76,67
9,33,Kanpur Nagar,Total,4572951,2469114,2103837,3324372,1880099,1444273,73,76,69
9,33,Kanpur Nagar,Rural,1557822,833912,723910,1030978,608226,422752,66,73,58
9,33,Kanpur Nagar,Urban,3015129,1635202,1379927,2293394,1271873,1021521,76,78,74
9,34,Jalaun ,Total,1670718,895804,774914,1090848,661434,429414,65,74,55
9,34,Jalaun ,Rural,1251964,673302,578662,798371,492865,305506,64,73,53
9,34,Jalaun ,Urban,418754,222502,196252,292477,168569,123908,70,76,63
9,35,Jhansi,Total,2000755,1061310,939445,1337700,802896,534804,67,76,57
9,35,Jhansi,Rural,1164749,616013,548736,722305,450271,272034,62,73,50
9,35,Jhansi,Urban,836006,445297,390709,615395,352625,262770,74,79,67
9,36,Lalitpur,Total,1218002,639392,578610,657292,406308,250984,54,64,43
9,36,Lalitpur,Rural,1042907,547870,495037,530768,334596,196172,51,61,40
9,36,Lalitpur,Urban,175095,91522,83573,126524,71712,54812,72,78,66
9,37,Hamirpur,Total,1104021,593576,510445,670362,418313,252049,61,70,49
9,37,Hamirpur,Rural,894707,481573,413134,525783,333040,192743,59,69,47
9,37,Hamirpur,Urban,209314,112003,97311,144579,85273,59306,69,76,61
9,38,Mahoba,Total,876055,465937,410118,502939,311027,191912,57,67,47
9,38,Mahoba,Rural,690377,367311,323066,380915,239318,141597,55,65,44
9,38,Mahoba,Urban,185678,98626,87052,122024,71709,50315,66,73,58
9,39,Banda,Total,1799541,966123,833418,1028356,645727,382629,57,67,46
9,39,Banda,Rural,1523378,819025,704353,832303,531842,300461,55,65,43
9,39,Banda,Urban,276163,147098,129065,196053,113885,82168,71,77,64
9,40,Chitrakoot,Total,990626,527101,463525,544866,338479,206387,55,64,45
9,40,Chitrakoot,Rural,894274,476142,418132,480200,300802,179398,54,63,43
9,40,Chitrakoot,Urban,96352,50959,45393,64666,37677,26989,67,74,59
9,41,Fatehpur,Total,2632684,1385556,1247128,1551416,934533,616883,59,67,49
9,41,Fatehpur,Rural,2310086,1216122,1093964,1332491,810869,521622,58,67,48
9,41,Fatehpur,Urban,322598,169434,153164,218925,123664,95261,68,73,62
9,42,Pratapgarh,Total,3173752,1591480,1582272,2007311,1166887,840424,63,73,53
9,42,Pratapgarh,Rural,2997891,1499782,1498109,1878437,1094299,784138,63,73,52
9,42,Pratapgarh,Urban,175861,91698,84163,128874,72588,56286,73,79,67
9,43,Kaushambi,Total,1596909,838095,758814,849280,528440,320840,53,63,42
9,43,Kaushambi,Rural,1472538,772938,699600,772119,483722,288397,52,63,41
9,43,Kaushambi,Urban,124371,65157,59214,77161,44718,32443,62,69,55
9,44,Allahabad ,Total,5959798,3133479,2826319,3815153,2291418,1523735,64,73,54
9,44,Allahabad ,Rural,4483188,2340830,2142358,2692508,1656316,1036192,60,71,48
9,44,Allahabad ,Urban,1476610,792649,683961,1122645,635102,487543,76,80,71
9,45,Bara Banki,Total,3257983,1707951,1550032,1755861,1048744,707117,54,61,46
9,45,Bara Banki,Rural,2927736,1534465,1393271,1550841,934206,616635,53,61,44
9,45,Bara Banki,Urban,330247,173486,156761,205020,114538,90482,62,66,58
9,46,Faizabad,Total,2468371,1258455,1209916,1498283,864989,633294,61,69,52
9,46,Faizabad,Rural,2125588,1076551,1049037,1247205,724520,522685,59,67,50
9,46,Faizabad,Urban,342783,181904,160879,251078,140469,110609,73,77,69
9,47,Ambedkar Nagar,Total,2398709,1214225,1184484,1542500,878110,664390,64,72,56
9,47,Ambedkar Nagar,Rural,2117138,1068915,1048223,1348742,770893,577849,64,72,55
9,47,Ambedkar Nagar,Urban,281571,145310,136261,193758,107217,86541,69,74,64
9,48,Sultanpur,Total,3790922,1916297,1874625,2313299,1341002,972297,61,70,52
9,48,Sultanpur,Rural,3590747,1811839,1778908,2163619,1258132,905487,60,69,51
9,48,Sultanpur,Urban,200175,104458,95717,149680,82870,66810,75,79,70
9,49,Bahraich,Total,3478257,1838988,1639269,1452832,909659,543173,42,49,33
9,49,Bahraich,Rural,3191039,1689216,1501823,1279928,814795,465133,40,48,31
9,49,Bahraich,Urban,287218,149772,137446,172904,94864,78040,60,63,57
9,50,Shrawasti,Total,1114615,594318,520297,447996,291159,156837,40,49,30
9,50,Shrawasti,Rural,1076166,574166,502000,425719,278544,147175,40,49,29
9,50,Shrawasti,Urban,38449,20152,18297,22277,12615,9662,58,63,53
9,51,Balrampur,Total,2149066,1117984,1031082,912960,568621,344339,42,51,33
9,51,Balrampur,Rural,1982784,1031001,951783,813475,512554,300921,41,50,32
9,51,Balrampur,Urban,166282,86983,79299,99485,56067,43418,60,64,55
9,52,Gonda,Total,3431386,1785629,1645757,1764652,1084843,679809,51,61,41
9,52,Gonda,Rural,3206240,1669142,1537098,1609233,998181,611052,50,60,40
9,52,Gonda,Urban,225146,116487,108659,155419,86662,68757,69,74,63
9,53,Siddharthnagar,Total,2553526,1296046,1257480,1290513,777518,512995,51,60,41
9,53,Siddharthnagar,Rural,2393289,1212726,1180563,1188210,719260,468950,50,59,40
9,53,Siddharthnagar,Urban,160237,83320,76917,102303,58258,44045,64,70,57
9,54,Basti,Total,2461056,1256158,1204898,1455656,856847,598809,59,68,50
9,54,Basti,Rural,2322939,1183666,1139273,1351994,798851,553143,58,67,49
9,54,Basti,Urban,138117,72492,65625,103662,57996,45666,75,80,70
9,55,Sant Kabir Nagar,Total,1714300,870547,843753,995207,589493,405714,58,68,48
9,55,Sant Kabir Nagar,Rural,1586160,803811,782349,909626,540710,368916,57,67,47
9,55,Sant Kabir Nagar,Urban,128140,66736,61404,85581,48783,36798,67,73,60
9,56,Mahrajganj,Total,2665292,1375367,1289925,1455270,905332,549938,55,66,43
9,56,Mahrajganj,Rural,2530502,1305592,1224910,1360244,851218,509026,54,65,42
9,56,Mahrajganj,Urban,134790,69775,65015,95026,54114,40912,70,78,63
9,57,Gorakhpur,Total,4436275,2281763,2154512,2813408,1661592,1151816,63,73,53
9,57,Gorakhpur,Rural,3603294,1843088,1760206,2179194,1306620,872574,60,71,50
9,57,Gorakhpur,Urban,832981,438675,394306,634214,354972,279242,76,81,71
9,58,Kushinagar,Total,3560830,1821242,1739588,2036239,1228354,807885,57,67,46
9,58,Kushinagar,Rural,3392768,1733709,1659059,1923186,1164164,759022,57,67,46
9,58,Kushinagar,Urban,168062,87533,80529,113053,64190,48863,67,73,61
9,59,Deoria,Total,3098637,1539608,1559029,1950953,1125530,825423,63,73,53
9,59,Deoria,Rural,2781739,1374765,1406974,1723371,997443,725928,62,73,52
9,59,Deoria,Urban,316898,164843,152055,227582,128087,99495,72,78,65
9,60,Azamgarh,Total,4616509,2289336,2327173,2860821,1606696,1254125,62,70,54
9,60,Azamgarh,Rural,4223125,2086704,2136421,2592453,1459714,1132739,61,70,53
9,60,Azamgarh,Urban,393384,202632,190752,268368,146982,121386,68,73,64
9,61,Mau,Total,2205170,1114888,1090282,1411217,799261,611956,64,72,56
9,61,Mau,Rural,1705386,858391,846995,1073360,613675,459685,63,71,54
9,61,Mau,Urban,499784,256497,243287,337857,185586,152271,68,72,63
9,62,Ballia,Total,3223642,1667557,1556085,2048447,1219027,829420,64,73,53
9,62,Ballia,Rural,2919799,1507966,1411833,1835297,1097860,737437,63,73,52
9,62,Ballia,Urban,303843,159591,144252,213150,121167,91983,70,76,64
9,63,Jaunpur,Total,4476072,2217635,2258437,2823528,1619657,1203871,63,73,53
9,63,Jaunpur,Rural,4142423,2043717,2098706,2586031,1487882,1098149,62,73,52
9,63,Jaunpur,Urban,333649,173918,159731,237497,131775,105722,71,76,66
9,64,Ghazipur,Total,3622727,1856584,1766143,2290660,1350115,940545,63,73,53
9,64,Ghazipur,Rural,3348855,1713157,1635698,2095556,1239690,855866,63,72,52
9,64,Ghazipur,Urban,273872,143427,130445,195104,110425,84679,71,77,65
9,65,Chandauli,Total,1952713,1020789,931924,1217507,724475,493032,62,71,53
9,65,Chandauli,Rural,1707610,892183,815427,1050830,630110,420720,62,71,52
9,65,Chandauli,Urban,245103,128606,116497,166677,94365,72312,68,73,62
9,66,Varanasi,Total,3682194,1928641,1753553,2468572,1426908,1041664,67,74,59
9,66,Varanasi,Rural,2082934,1081293,1001641,1342638,794986,547652,64,74,55
9,66,Varanasi,Urban,1599260,847348,751912,1125934,631922,494012,70,75,66
9,67,Sant Ravidas Nagar (Bhadohi),Total,1554203,797164,757039,931483,560736,370747,60,70,49
9,67,Sant Ravidas Nagar (Bhadohi),Rural,1325312,676884,648428,785065,475673,309392,59,70,48
9,67,Sant Ravidas Nagar (Bhadohi),Urban,228891,120280,108611,146418,85063,61355,64,71,56
9,68,Mirzapur,Total,2494533,1312822,1181711,1479704,894532,585172,59,68,50
9,68,Mirzapur,Rural,2148058,1128022,1020036,1244823,758189,486634,58,67,48
9,68,Mirzapur,Urban,346475,184800,161675,234881,136343,98538,68,74,61
9,69,Sonbhadra,Total,1862612,973480,889132,1028280,627297,400983,55,64,45
9,69,Sonbhadra,Rural,1548549,805318,743231,788139,489209,298930,51,61,40
9,69,Sonbhadra,Urban,314063,168162,145901,240141,138088,102053,76,82,70
9,70,Etah,Total,1761152,945157,815995,1086970,663457,423513,62,70,52
9,70,Etah,Rural,1492704,802802,689902,904919,560545,344374,61,70,50
9,70,Etah,Urban,268448,142355,126093,182051,102912,79139,68,72,63
9,71,Kanshiram Nagar,Total,1438156,765529,672627,743479,463617,279862,52,61,42
9,71,Kanshiram Nagar,Rural,1149795,613637,536158,580038,369036,211002,50,60,39
9,71,Kanshiram Nagar,Urban,288361,151892,136469,163441,94581,68860,57,62,50
10,0,BIHAR,Total,103804637,54185347,49619290,54390254,32711975,21678279,52,60,44
10,0,BIHAR,Rural,92075028,47983851,44091177,46478818,28221885,18256933,50,59,41
10,0,BIHAR,Urban,11729609,6201496,5528113,7911436,4490090,3421346,67,72,62
10,1,Pashchim Champaran,Total,3922780,2057669,1865111,1839984,1139136,700848,47,55,38
10,1,Pashchim Champaran,Rural,3528781,1849168,1679613,1597973,999503,598470,45,54,36
10,1,Pashchim Champaran,Urban,393999,208501,185498,242011,139633,102378,61,67,55
10,2,Purba Champaran,Total,5082868,2674037,2408831,2382348,1467319,915029,47,55,38
10,2,Purba Champaran,Rural,4683820,2462046,2221774,2138932,1326316,812616,46,54,37
10,2,Purba Champaran,Urban,399048,211991,187057,243416,141003,102413,61,67,55
10,3,Sheohar,Total,656916,347614,309302,297938,180154,117784,45,52,38
10,3,Sheohar,Rural,628821,332738,296083,282966,171181,111785,45,51,38
10,3,Sheohar,Urban,28095,14876,13219,14972,8973,5999,53,60,45
10,4,Sitamarhi,Total,3419622,1800441,1619181,1485896,917879,568017,43,51,35
10,4,Sitamarhi,Rural,3228904,1698885,1530019,1365865,848694,517171,42,50,34
10,4,Sitamarhi,Urban,190718,101556,89162,120031,69185,50846,63,68,57
10,5,Madhubani,Total,4476044,2324984,2151060,2251107,1393708,857399,50,60,40
10,5,Madhubani,Rural,4311466,2238181,2073285,2148976,1333918,815058,50,60,39
10,5,Madhubani,Urban,164578,86803,77775,102131,59790,42341,62,69,54
10,6,Supaul,Total,2228397,1157815,1070582,1076133,672945,403188,48,58,38
10,6,Supaul,Rural,2122869,1101955,1020914,1010258,634158,376100,48,58,37
10,6,Supaul,Urban,105528,55860,49668,65875,38787,27088,62,69,55
10,7,Araria,Total,2806200,1460878,1345322,1235303,751900,483403,44,51,36
10,7,Araria,Rural,2637656,1371982,1265674,1131940,692520,439420,43,50,35
10,7,Araria,Urban,168544,88896,79648,103363,59380,43983,61,67,55
10,8,Kishanganj,Total,1690948,868845,822103,769439,455615,313824,46,52,38
10,8,Kishanganj,Rural,1527249,783653,743596,669160,398960,270200,44,51,36
10,8,Kishanganj,Urban,163699,85192,78507,100279,56655,43624,61,67,56
10,9,Purnia,Total,3273127,1695829,1577298,1380052,834533,545519,42,49,35
10,9,Purnia,Rural,2932527,1516355,1416172,1165222,712890,452332,40,47,32
10,9,Purnia,Urban,340600,179474,161126,214830,121643,93187,63,68,58
10,10,Katihar,Total,3068149,1601158,1466991,1321024,788969,532055,43,49,36
10,10,Katihar,Rural,2794765,1456907,1337858,1136202,684507,451695,41,47,34
10,10,Katihar,Urban,273384,144251,129133,184822,104462,80360,68,72,62
10,11,Madhepura,Total,1994618,1042373,952245,858886,533342,325544,43,51,34
10,11,Madhepura,Rural,1906448,995731,910717,803270,501175,302095,42,50,33
10,11,Madhepura,Urban,88170,46642,41528,55616,32167,23449,63,69,56
10,12,Saharsa,Total,1897102,995502,901600,829206,521560,307646,44,52,34
10,12,Saharsa,Rural,1741927,912913,829014,727781,462871,264910,42,51,32
10,12,Saharsa,Urban,155175,82589,72586,101425,58689,42736,65,71,59
10,13,Darbhanga,Total,3921971,2053043,1868928,1876638,1158664,717974,48,56,38
10,13,Darbhanga,Rural,3541846,1852977,1688869,1625085,1014868,610217,46,55,36
10,13,Darbhanga,Urban,380125,200066,180059,251553,143796,107757,66,72,60
10,14,Muzaffarpur,Total,4778610,2517500,2261110,2601665,1539154,1062511,54,61,47
10,14,Muzaffarpur,Rural,4308714,2268489,2040225,2264092,1350850,913242,53,60,45
10,14,Muzaffarpur,Urban,469896,249011,220885,337573,188304,149269,72,76,68
10,15,Gopalganj,Total,2558037,1269677,1288360,1421866,818991,602875,56,65,47
10,15,Gopalganj,Rural,2396270,1187067,1209203,1317335,760067,557268,55,64,46
10,15,Gopalganj,Urban,161767,82610,79157,104531,58924,45607,65,71,58
10,16,Siwan,Total,3318176,1672121,1646055,1994056,1155972,838084,60,69,51
10,16,Siwan,Rural,3135865,1576783,1559082,1864407,1082341,782066,59,69,50
10,16,Siwan,Urban,182311,95338,86973,129649,73631,56018,71,77,64
10,17,Saran,Total,3943098,2023476,1919622,2252914,1340226,912688,57,66,48
10,17,Saran,Rural,3591053,1839077,1751976,2019825,1207885,811940,56,66,46
10,17,Saran,Urban,352045,184399,167646,233089,132341,100748,66,72,60
10,18,Vaishali,Total,3495249,1847058,1648191,1990809,1181754,809055,57,64,49
10,18,Vaishali,Rural,3262715,1723227,1539488,1839275,1094486,744789,56,64,48
10,18,Vaishali,Urban,232534,123831,108703,151534,87268,64266,65,70,59
10,19,Samastipur,Total,4254782,2228432,2026350,2214498,1333406,881092,52,60,43
10,19,Samastipur,Rural,4107725,2150966,1956759,2110007,1274768,835239,51,59,43
10,19,Samastipur,Urban,147057,77466,69591,104491,58638,45853,71,76,66
10,20,Begusarai,Total,2954367,1560203,1394164,1604148,953052,651096,54,61,47
10,20,Begusarai,Rural,2387311,1260269,1127042,1248020,749193,498827,52,59,44
10,20,Begusarai,Urban,567056,299934,267122,356128,203859,152269,63,68,57
10,21,Khagaria,Total,1657599,880065,777534,797784,478545,319239,48,54,41
10,21,Khagaria,Rural,1570470,833311,737159,740101,445659,294442,47,53,40
10,21,Khagaria,Urban,87129,46754,40375,57683,32886,24797,66,70,61
10,22,Bhagalpur,Total,3032226,1614014,1418212,1623909,967924,655985,54,60,46
10,22,Bhagalpur,Rural,2432126,1294753,1137373,1225896,742131,483765,50,57,43
10,22,Bhagalpur,Urban,600100,319261,280839,398013,225793,172220,66,71,61
10,23,Banka,Total,2029339,1064307,965032,1002069,612053,390016,49,58,40
10,23,Banka,Rural,1957988,1026257,931731,957613,586478,371135,49,57,40
10,23,Banka,Urban,71351,38050,33301,44456,25575,18881,62,67,57
10,24,Munger,Total,1359054,723280,635774,834162,487096,347066,61,67,55
10,24,Munger,Rural,974425,518935,455490,560814,332724,228090,58,64,50
10,24,Munger,Urban,384629,204345,180284,273348,154372,118976,71,76,66
10,25,Lakhisarai,Total,1000717,526651,474066,531633,319208,212425,53,61,45
10,25,Lakhisarai,Rural,857751,451052,406699,444260,268305,175955,52,59,43
10,25,Lakhisarai,Urban,142966,75599,67367,87373,50903,36470,61,67,54
10,26,Sheikhpura,Total,634927,329593,305334,340799,204533,136266,54,62,45
10,26,Sheikhpura,Rural,526132,272244,253888,274558,165937,108621,52,61,43
10,26,Sheikhpura,Urban,108795,57349,51446,66241,38596,27645,61,67,54
10,27,Nalanda,Total,2872523,1495577,1376946,1574818,952970,621848,55,64,45
10,27,Nalanda,Rural,2415034,1256466,1158568,1283214,783707,499507,53,62,43
10,27,Nalanda,Urban,457489,239111,218378,291604,169263,122341,64,71,56
10,28,Patna,Total,5772804,3051117,2721687,3527409,2066494,1460915,61,68,54
10,28,Patna,Rural,3262711,1718206,1544505,1717071,1058019,659052,53,62,43
10,28,Patna,Urban,2510093,1332911,1177182,1810338,1008475,801863,72,76,68
10,29,Bhojpur,Total,2720155,1431722,1288433,1659049,1010138,648911,61,71,50
10,29,Bhojpur,Rural,2331450,1225247,1106203,1390042,855599,534443,60,70,48
10,29,Bhojpur,Urban,388705,206475,182230,269007,154539,114468,69,75,63
10,30,Buxar,Total,1707643,888356,819287,1019682,611944,407738,60,69,50
10,30,Buxar,Rural,1543476,801572,741904,905202,546796,358406,59,68,48
10,30,Buxar,Urban,164167,86784,77383,114480,65148,49332,70,75,64
10,31,Kaimur (Bhabua),Total,1626900,847784,779116,948105,568197,379908,58,67,49
10,31,Kaimur (Bhabua),Rural,1561538,813051,748487,900497,541103,359394,58,67,48
10,31,Kaimur (Bhabua),Urban,65362,34733,30629,47608,27094,20514,73,78,67
10,32,Rohtas,Total,2962593,1547856,1414737,1866684,1101703,764981,63,71,54
10,32,Rohtas,Rural,2535085,1322509,1212576,1571583,933626,637957,62,71,53
10,32,Rohtas,Urban,427508,225347,202161,295101,168077,127024,69,75,63
10,33,Aurangabad,Total,2511243,1310867,1200376,1508596,895834,612762,60,68,51
10,33,Aurangabad,Rural,2275761,1187062,1088699,1347478,804431,543047,59,68,50
10,33,Aurangabad,Urban,235482,123805,111677,161118,91403,69715,68,74,62
10,34,Gaya,Total,4379383,2266865,2112518,2399682,1427447,972235,55,63,46
10,34,Gaya,Rural,3803888,1962454,1841434,1980251,1191791,788460,52,61,43
10,34,Gaya,Urban,575495,304411,271084,419431,235656,183775,73,77,68
10,35,Nawada,Total,2216653,1145123,1071530,1139832,685513,454319,51,60,42
10,35,Nawada,Rural,2001120,1032273,968847,997131,604950,392181,50,59,40
10,35,Nawada,Urban,215533,112850,102683,142701,80563,62138,66,71,61
10,36,Jamui,Total,1756078,914368,841710,896670,556264,340406,51,61,40
10,36,Jamui,Rural,1611431,838318,773113,803379,502282,301097,50,60,39
10,36,Jamui,Urban,144647,76050,68597,93291,53982,39309,64,71,57
10,37,Jehanabad ,Total,1124176,586202,537974,635022,384670,250352,56,66,47
10,37,Jehanabad ,Rural,989816,514724,475092,545932,333548,212384,55,65,45
10,37,Jehanabad ,Urban,134360,71478,62882,89090,51122,37968,66,72,60
10,38,Arwal,Total,699563,362945,336618,400439,243163,157276,57,67,47
10,38,Arwal,Rural,648094,336048,312046,367205,223648,143557,57,67,46
10,38,Arwal,Urban,51469,26897,24572,33234,19515,13719,65,73,56
11,0,SIKKIM,Total,607688,321661,286027,449294,253364,195930,74,79,69
11,0,SIKKIM,Rural,455962,242122,213840,326398,186246,140152,72,77,66
11,0,SIKKIM,Urban,151726,79539,72187,122896,67118,55778,81,84,77
11,1,North District,Total,43354,24513,18841,30084,18392,11692,69,75,62
11,1,North District,Rural,38706,22052,16654,26700,16503,10197,69,75,61
11,1,North District,Urban,4648,2461,2187,3384,1889,1495,73,77,68
11,2,West District,Total,136299,70225,66074,95481,53084,42397,70,76,64
11,2,West District,Rural,131060,67522,63538,91202,50777,40425,70,75,64
11,2,West District,Urban,5239,2703,2536,4279,2307,1972,82,85,78
11,3,South District,Total,146742,76663,70079,108054,60007,48047,74,78,69
11,3,South District,Rural,125653,65887,59766,91240,51072,40168,73,78,67
11,3,South District,Urban,21089,10776,10313,16814,8935,7879,80,83,76
11,4,East District,Total,281293,150260,131033,215675,121881,93794,77,81,72
11,4,East District,Rural,160543,86661,73882,117256,67894,49362,73,78,67
11,4,East District,Urban,120750,63599,57151,98419,53987,44432,82,85,78
12,0,ARUNACHAL PRADESH,Total,1382611,720232,662379,789943,454532,335411,57,63,51
12,0,ARUNACHAL PRADESH,Rural,1069165,554304,514861,557105,323657,233448,52,58,45
12,0,ARUNACHAL PRADESH,Urban,313446,165928,147518,232838,130875,101963,74,79,69
12,1,Tawang,Total,49950,29361,20589,26861,18200,8661,54,62,42
12,1,Tawang,Rural,44323,26497,17826,22667,15892,6775,51,60,38
12,1,Tawang,Urban,5627,2864,2763,4194,2308,1886,75,81,68
12,2,West Kameng,Total,87013,49568,37445,52473,33111,19362,60,67,52
12,2,West Kameng,Rural,68654,39012,29642,38947,24649,14298,57,63,48
12,2,West Kameng,Urban,18359,10556,7803,13526,8462,5064,74,80,65
12,3,East Kameng,Total,78413,38974,39439,40244,22609,17635,51,58,45
12,3,East Kameng,Rural,60156,29793,30363,28536,16072,12464,47,54,41
12,3,East Kameng,Urban,18257,9181,9076,11708,6537,5171,64,71,57
12,4,Papum Pare,Total,176385,90447,85938,125429,68458,56971,71,76,66
12,4,Papum Pare,Rural,79500,40471,39029,51158,28247,22911,64,70,59
12,4,Papum Pare,Urban,96885,49976,46909,74271,40211,34060,77,80,73
12,5,Upper Subansiri,Total,83205,41974,41231,45984,24404,21580,55,58,52
12,5,Upper Subansiri,Rural,69595,34733,34862,36380,18865,17515,52,54,50
12,5,Upper Subansiri,Urban,13610,7241,6369,9604,5539,4065,71,76,64
12,6,West Siang,Total,112272,58589,53683,66546,37981,28565,59,65,53
12,6,West Siang,Rural,87311,44866,42445,47030,26665,20365,54,59,48
12,6,West Siang,Urban,24961,13723,11238,19516,11316,8200,78,82,73
12,7,East Siang,Total,99019,50467,48552,63905,35017,28888,65,69,59
12,7,East Siang,Rural,71417,36318,35099,43858,24178,19680,61,67,56
12,7,East Siang,Urban,27602,14149,13453,20047,10839,9208,73,77,68
12,8,Upper Siang,Total,35289,18657,16632,18378,10450,7928,52,56,48
12,8,Upper Siang,Rural,28743,15289,13454,13757,7929,5828,48,52,43
12,8,Upper Siang,Urban,6546,3368,3178,4621,2521,2100,71,75,66
12,9,Changlang,Total,147951,77289,70662,75814,45489,30325,51,59,43
12,9,Changlang,Rural,128736,66467,62269,60924,36578,24346,47,55,39
12,9,Changlang,Urban,19215,10822,8393,14890,8911,5979,77,82,71
12,10,Tirap,Total,111997,57992,54005,48404,29751,18653,43,51,35
12,10,Tirap,Rural,91113,46278,44835,33270,20694,12576,37,45,28
12,10,Tirap,Urban,20884,11714,9170,15134,9057,6077,72,77,66
12,11,Lower Subansiri,Total,82839,41935,40904,55602,30374,25228,67,72,62
12,11,Lower Subansiri,Rural,70029,35476,34553,45715,25152,20563,65,71,60
12,11,Lower Subansiri,Urban,12810,6459,6351,9887,5222,4665,77,81,73
12,12,Kurung Kumey,Total,89717,44226,45491,37583,20831,16752,42,47,37
12,12,Kurung Kumey,Rural,87412,43033,44379,36299,20073,16226,42,47,37
12,12,Kurung Kumey,Urban,2305,1193,1112,1284,758,526,56,64,47
12,13,Dibang Valley,Total,7948,4396,3552,4435,2632,1803,56,60,51
12,13,Dibang Valley,Rural,5758,3272,2486,2921,1788,1133,51,55,46
12,13,Dibang Valley,Urban,2190,1124,1066,1514,844,670,69,75,63
12,14,Lower Dibang Valley,Total,53986,28127,25859,32565,18511,14054,60,66,54
12,14,Lower Dibang Valley,Rural,42601,22031,20570,23417,13423,9994,55,61,49
12,14,Lower Dibang Valley,Urban,11385,6096,5289,9148,5088,4060,80,83,77
12,15,Lohit,Total,145538,76544,68994,85206,49794,35412,59,65,51
12,15,Lohit,Rural,113700,59698,54002,62440,36981,25459,55,62,47
12,15,Lohit,Urban,31838,16846,14992,22766,12813,9953,72,76,66
12,16,Anjaw,Total,21089,11686,9403,10514,6920,3594,50,59,38
12,16,Anjaw,Rural,20117,11070,9047,9786,6471,3315,49,58,37
12,16,Anjaw,Urban,972,616,356,728,449,279,75,73,78
13,0,NAGALAND,Total,1980602,1025707,954895,1357579,731796,625783,69,71,66
13,0,NAGALAND,Rural,1406861,724595,682266,904799,487888,416911,64,67,61
13,0,NAGALAND,Urban,573741,301112,272629,452780,243908,208872,79,81,77
13,1,Mon,Total,250671,132062,118609,119496,67170,52326,48,51,44
13,1,Mon,Rural,215953,113573,102380,94014,53190,40824,44,47,40
13,1,Mon,Urban,34718,18489,16229,25482,13980,11502,73,76,71
13,2,Mokokchung,Total,193171,100229,92942,160453,84166,76287,83,84,82
13,2,Mokokchung,Rural,137517,70528,66989,113216,58741,54475,82,83,81
13,2,Mokokchung,Urban,55654,29701,25953,47237,25425,21812,85,86,84
13,3,Zunheboto,Total,141014,71169,69845,104294,54105,50189,74,76,72
13,3,Zunheboto,Rural,113409,56762,56647,81303,41902,39401,72,74,70
13,3,Zunheboto,Urban,27605,14407,13198,22991,12203,10788,83,85,82
13,4,Wokha,Total,166239,84429,81810,128394,67396,60998,77,80,75
13,4,Wokha,Rural,131254,66301,64953,98092,51485,46607,75,78,72
13,4,Wokha,Urban,34985,18128,16857,30302,15911,14391,87,88,85
13,5,Dimapur,Total,379769,198163,181606,282088,152327,129761,74,77,71
13,5,Dimapur,Rural,182492,94501,87991,129370,70112,59258,71,74,67
13,5,Dimapur,Urban,197277,103662,93615,152718,82215,70503,77,79,75
13,6,Phek,Total,163294,83684,79610,107427,58587,48840,66,70,61
13,6,Phek,Rural,138689,70454,68235,88646,48052,40594,64,68,59
13,6,Phek,Urban,24605,13230,11375,18781,10535,8246,76,80,72
13,7,Tuensang,Total,196801,101977,94824,119293,64426,54867,61,63,58
13,7,Tuensang,Rural,159960,82485,77475,90346,48621,41725,56,59,54
13,7,Tuensang,Urban,36841,19492,17349,28947,15805,13142,79,81,76
13,8,Longleng,Total,50593,26588,24005,30518,16548,13970,60,62,58
13,8,Longleng,Rural,42984,22594,20390,24584,13376,11208,57,59,55
13,8,Longleng,Urban,7609,3994,3615,5934,3172,2762,78,79,76
13,9,Kiphire,Total,74033,37758,36275,42445,23290,19155,57,62,53
13,9,Kiphire,Rural,57536,29203,28333,30238,16709,13529,53,57,48
13,9,Kiphire,Urban,16497,8555,7942,12207,6581,5626,74,77,71
13,10,Kohima,Total,270063,140118,129945,200180,108781,91399,74,78,70
13,10,Kohima,Rural,146914,76370,70544,102993,56836,46157,70,74,65
13,10,Kohima,Urban,123149,63748,59401,97187,51945,45242,79,81,76
13,11,Peren,Total,94954,49530,45424,62991,35000,27991,66,71,62
13,11,Peren,Rural,80153,41824,38329,51997,28864,23133,65,69,60
13,11,Peren,Urban,14801,7706,7095,10994,6136,4858,74,80,68
14,0,MANIPUR ,Total,2721756,1369764,1351992,1891196,1026733,864463,69,75,64
14,0,MANIPUR ,Rural,1899624,966264,933360,1268881,701862,567019,67,73,61
14,0,MANIPUR ,Urban,822132,403500,418632,622315,324871,297444,76,81,71
14,1,Senapati,Total,354972,183081,171891,232149,128806,103343,65,70,60
14,1,Senapati,Rural,347518,179374,168144,226452,125829,100623,65,70,60
14,1,Senapati,Urban,7454,3707,3747,5697,2977,2720,76,80,73
14,2,Tamenglong,Total,140143,71762,68381,85939,47928,38011,61,67,56
14,2,Tamenglong,Rural,124416,63745,60671,73838,41472,32366,59,65,53
14,2,Tamenglong,Urban,15727,8017,7710,12101,6456,5645,77,81,73
14,3,Churachandpur,Total,271274,137748,133526,199594,106026,93568,74,77,70
14,3,Churachandpur,Rural,253901,129276,124625,185675,98966,86709,73,77,70
14,3,Churachandpur,Urban,17373,8472,8901,13919,7060,6859,80,83,77
14,4,Bishnupur,Total,240363,120185,120178,160740,89486,71254,67,74,59
14,4,Bishnupur,Rural,152068,76605,75463,98652,55884,42768,65,73,57
14,4,Bishnupur,Urban,88295,43580,44715,62088,33602,28486,70,77,64
14,5,Thoubal,Total,420517,209674,210843,271035,150585,120450,64,72,57
14,5,Thoubal,Rural,271311,135981,135330,168923,96020,72903,62,71,54
14,5,Thoubal,Urban,149206,73693,75513,102112,54565,47547,68,74,63
14,6,Imphal West,Total,514683,253628,261055,395731,207844,187887,77,82,72
14,6,Imphal West,Rural,196091,98275,97816,142665,77441,65224,73,79,67
14,6,Imphal West,Urban,318592,155353,163239,253066,130403,122663,79,84,75
14,7,Imphal East,Total,452661,225130,227531,324535,174044,150491,72,77,66
14,7,Imphal East,Rural,270307,136347,133960,182479,101009,81470,68,74,61
14,7,Imphal East,Urban,182354,88783,93571,142056,73035,69021,78,82,74
14,8,Ukhrul,Total,183115,94013,89102,131118,70618,60500,72,75,68
14,8,Ukhrul,Rural,156893,80834,76059,110431,59949,50482,70,74,66
14,8,Ukhrul,Urban,26222,13179,13043,20687,10669,10018,79,81,77
14,9,Chandel,Total,144028,74543,69485,90355,51396,38959,63,69,56
14,9,Chandel,Rural,127119,65827,61292,79766,45292,34474,63,69,56
14,9,Chandel,Urban,16909,8716,8193,10589,6104,4485,63,70,55
15,0,MIZORAM,Total,1091014,552339,538675,847592,438949,408643,78,79,76
15,0,MIZORAM,Rural,529037,271319,257718,368672,198486,170186,70,73,66
15,0,MIZORAM,Urban,561977,281020,280957,478920,240463,238457,85,86,85
15,1,Mamit,Total,85757,44567,41190,60979,33427,27552,71,75,67
15,1,Mamit,Rural,70948,36945,34003,49349,27371,21978,70,74,65
15,1,Mamit,Urban,14809,7622,7187,11630,6056,5574,79,79,78
15,2,Kolasib,Total,83054,42456,40598,66510,34438,32072,80,81,79
15,2,Kolasib,Rural,36358,18735,17623,27613,14514,13099,76,77,74
15,2,Kolasib,Urban,46696,23721,22975,38897,19924,18973,83,84,83
15,3,Aizawl,Total,404054,201072,202982,346465,172974,173491,86,86,85
15,3,Aizawl,Rural,91217,46828,44389,75250,38947,36303,82,83,82
15,3,Aizawl,Urban,312837,154244,158593,271215,134027,137188,87,87,87
15,4,Champhai,Total,125370,63299,62071,96601,49417,47184,77,78,76
15,4,Champhai,Rural,77153,39190,37963,57537,29718,27819,75,76,73
15,4,Champhai,Urban,48217,24109,24108,39064,19699,19365,81,82,80
15,5,Serchhip,Total,64875,32824,32051,55102,27893,27209,85,85,85
15,5,Serchhip,Rural,32894,16625,16269,27417,13881,13536,83,83,83
15,5,Serchhip,Urban,31981,16199,15782,27685,14012,13673,87,86,87
15,6,Lunglei,Total,154094,79252,74842,116669,62365,54304,76,79,73
15,6,Lunglei,Rural,92611,47550,45061,63041,34582,28459,68,73,63
15,6,Lunglei,Urban,61483,31702,29781,53628,27783,25845,87,88,87
15,7,Lawngtlai,Total,117444,60379,57065,63524,36810,26714,54,61,47
15,7,Lawngtlai,Rural,96555,49671,46884,46579,27986,18593,48,56,40
15,7,Lawngtlai,Urban,20889,10708,10181,16945,8824,8121,81,82,80
15,8,Saiha,Total,56366,28490,27876,41742,21625,20117,74,76,72
15,8,Saiha,Rural,31301,15775,15526,21886,11487,10399,70,73,67
15,8,Saiha,Urban,25065,12715,12350,19856,10138,9718,79,80,79
16,0,TRIPURA,Total,3671032,1871867,1799165,2831742,1515973,1315769,77,81,73
16,0,TRIPURA,Rural,2710051,1385505,1324546,2016022,1094184,921838,74,79,70
16,0,TRIPURA,Urban,960981,486362,474619,815720,421789,393931,85,87,83
16,1,West Tripura ,Total,1724619,877930,846689,1369122,727353,641769,79,83,76
16,1,West Tripura ,Rural,1047345,535911,511434,795449,431281,364168,76,80,71
16,1,West Tripura ,Urban,677274,342019,335255,573673,296072,277601,85,87,83
16,2,South Tripura ,Total,875144,447124,428020,654503,355784,298719,75,80,70
16,2,South Tripura ,Rural,752139,384418,367721,549372,300805,248567,73,78,68
16,2,South Tripura ,Urban,123005,62706,60299,105131,54979,50152,85,88,83
16,3,Dhalai,Total,377988,194342,183646,280930,154161,126769,74,79,69
16,3,Dhalai,Rural,337513,173599,163914,246210,136027,110183,73,78,67
16,3,Dhalai,Urban,40475,20743,19732,34720,18134,16586,86,87,84
16,4,North Tripura,Total,693281,352471,340810,527187,278675,248512,76,79,73
16,4,North Tripura,Rural,573054,291577,281477,424991,226071,198920,74,78,71
16,4,North Tripura,Urban,120227,60894,59333,102196,52604,49592,85,86,84
17,0,MEGHALAYA,Total,2964007,1492668,1471339,1817761,934091,883670,61,63,60
17,0,MEGHALAYA,Rural,2368971,1194757,1174214,1345805,693793,652012,57,58,56
17,0,MEGHALAYA,Urban,595036,297911,297125,471956,240298,231658,79,81,78
17,1,West Garo Hills,Total,642923,324900,318023,362975,196674,166301,56,61,52
17,1,West Garo Hills,Rural,567845,287296,280549,303659,166264,137395,53,58,49
17,1,West Garo Hills,Urban,75078,37604,37474,59316,30410,28906,79,81,77
17,2,East Garo Hills,Total,317618,161372,156246,196739,105401,91338,62,65,58
17,2,East Garo Hills,Rural,273378,138776,134602,161696,87197,74499,59,63,55
17,2,East Garo Hills,Urban,44240,22596,21644,35043,18204,16839,79,81,78
17,3,South Garo Hills,Total,142574,73322,69252,83373,45628,37745,58,62,55
17,3,South Garo Hills,Rural,129530,66714,62816,73489,40497,32992,57,61,53
17,3,South Garo Hills,Urban,13044,6608,6436,9884,5131,4753,76,78,74
17,4,West Khasi Hills,Total,385601,194628,190973,237102,121049,116053,61,62,61
17,4,West Khasi Hills,Rural,342613,173378,169235,206538,105968,100570,60,61,59
17,4,West Khasi Hills,Urban,42988,21250,21738,30564,15081,15483,71,71,71
17,5,Ribhoi,Total,258380,132445,125935,159723,83308,76415,62,63,61
17,5,Ribhoi,Rural,233226,118610,114616,141700,73033,68667,61,62,60
17,5,Ribhoi,Urban,25154,13835,11319,18023,10275,7748,72,74,68
17,6,East Khasi Hills,Total,824059,410360,413699,584156,291431,292725,71,71,71
17,6,East Khasi Hills,Rural,458010,228118,229892,287806,141260,146546,63,62,64
17,6,East Khasi Hills,Urban,366049,182242,183807,296350,150171,146179,81,82,80
17,7,Jaintia Hills,Total,392852,195641,197211,193693,90600,103093,49,46,52
17,7,Jaintia Hills,Rural,364369,181865,182504,170917,79574,91343,47,44,50
17,7,Jaintia Hills,Urban,28483,13776,14707,22776,11026,11750,80,80,80
18,0,ASSAM,Total,31169272,15954927,15214345,19507017,10756937,8750080,63,67,58
18,0,ASSAM,Rural,26780516,13689739,13090777,15988262,8878355,7109907,60,65,54
18,0,ASSAM,Urban,4388756,2265188,2123568,3518755,1878582,1640173,80,83,77
18,1,Kokrajhar,Total,886999,452965,434034,503178,283026,220152,57,62,51
18,1,Kokrajhar,Rural,832249,424621,407628,459155,259109,200046,55,61,49
18,1,Kokrajhar,Urban,54750,28344,26406,44023,23917,20106,80,84,76
18,2,Dhubri,Total,1948632,998346,950286,943680,523682,419998,48,52,44
18,2,Dhubri,Rural,1746715,895246,851469,796343,444492,351851,46,50,41
18,2,Dhubri,Urban,201917,103100,98817,147337,79190,68147,73,77,69
18,3,Goalpara,Total,1008959,514162,494797,579038,311986,267052,57,61,54
18,3,Goalpara,Rural,871132,444188,426944,486547,262517,224030,56,59,52
18,3,Goalpara,Urban,137827,69974,67853,92491,49469,43022,67,71,63
18,4,Barpeta,Total,1693190,867891,825299,918708,512330,406378,54,59,49
18,4,Barpeta,Rural,1545901,792695,753206,802463,450015,352448,52,57,47
18,4,Barpeta,Urban,147289,75196,72093,116245,62315,53930,79,83,75
18,5,Morigaon,Total,957853,485328,472525,554143,297422,256721,58,61,54
18,5,Morigaon,Rural,884557,447782,436775,498740,267791,230949,56,60,53
18,5,Morigaon,Urban,73296,37546,35750,55403,29631,25772,76,79,72
18,6,Nagaon,Total,2826006,1440307,1385699,1755838,947986,807852,62,66,58
18,6,Nagaon,Rural,2457906,1252756,1205150,1461302,791020,670282,59,63,56
18,6,Nagaon,Urban,368100,187551,180549,294536,156966,137570,80,84,76
18,7,Sonitpur,Total,1925975,989919,936056,1160527,656995,503532,60,66,54
18,7,Sonitpur,Rural,1754835,901017,853818,1021634,581764,439870,58,65,52
18,7,Sonitpur,Urban,171140,88902,82238,138893,75231,63662,81,85,77
18,8,Lakhimpur,Total,1040644,529484,511160,697526,383026,314500,67,72,62
18,8,Lakhimpur,Rural,949348,482364,466984,626219,344778,281441,66,71,60
18,8,Lakhimpur,Urban,91296,47120,44176,71307,38248,33059,78,81,75
18,9,Dhemaji,Total,688077,353043,335034,406388,228330,178058,59,65,53
18,9,Dhemaji,Rural,639605,327877,311728,370205,208652,161553,58,64,52
18,9,Dhemaji,Urban,48472,25166,23306,36183,19678,16505,75,78,71
18,10,Tinsukia,Total,1316948,675986,640962,809796,457356,352440,61,68,55
18,10,Tinsukia,Rural,1053956,538210,515746,598332,343462,254870,57,64,49
18,10,Tinsukia,Urban,262992,137776,125216,211464,113894,97570,80,83,78
18,11,Dibrugarh,Total,1327748,680114,647634,893908,496362,397546,67,73,61
18,11,Dibrugarh,Rural,1083984,553442,530542,693388,389008,304380,64,70,57
18,11,Dibrugarh,Urban,243764,126672,117092,200520,107354,93166,82,85,80
18,12,Sivasagar,Total,1150253,589454,560799,826951,452009,374942,72,77,67
18,12,Sivasagar,Rural,1040376,531541,508835,735534,402804,332730,71,76,65
18,12,Sivasagar,Urban,109877,57913,51964,91417,49205,42212,83,85,81
18,13,Jorhat,Total,1091295,557944,533351,812328,440230,372098,74,79,70
18,13,Jorhat,Rural,871730,444389,427341,629728,343424,286304,72,77,67
18,13,Jorhat,Urban,219565,113555,106010,182600,96806,85794,83,85,81
18,14,Golaghat,Total,1058674,539949,518725,728513,399525,328988,69,74,63
18,14,Golaghat,Rural,960892,489777,471115,646433,356333,290100,67,73,62
18,14,Golaghat,Urban,97782,50172,47610,82080,43192,38888,84,86,82
18,15,Karbi Anglong,Total,965280,493482,471798,574509,326444,248065,60,66,53
18,15,Karbi Anglong,Rural,851158,433903,417255,484646,277276,207370,57,64,50
18,15,Karbi Anglong,Urban,114122,59579,54543,89863,49168,40695,79,83,75
18,16,Dima Hasao,Total,213529,110566,102963,143585,80498,63087,67,73,61
18,16,Dima Hasao,Rural,152302,77992,74310,92978,52505,40473,61,67,54
18,16,Dima Hasao,Urban,61227,32574,28653,50607,27993,22614,83,86,79
18,17,Cachar,Total,1736319,886616,849703,1196892,652827,544065,69,74,64
18,17,Cachar,Rural,1420309,727130,693179,942317,520395,421922,66,72,61
18,17,Cachar,Urban,316010,159486,156524,254575,132432,122143,81,83,78
18,18,Karimganj,Total,1217002,620722,596280,808165,443047,365118,66,71,61
18,18,Karimganj,Rural,1106745,564978,541767,715667,395185,320482,65,70,59
18,18,Karimganj,Urban,110257,55744,54513,92498,47862,44636,84,86,82
18,19,Hailakandi,Total,659260,338766,320494,413705,230567,183138,63,68,57
18,19,Hailakandi,Rural,611087,314577,296510,372302,209280,163022,61,67,55
18,19,Hailakandi,Urban,48173,24189,23984,41403,21287,20116,86,88,84
18,20,Bongaigaon,Total,732639,373590,359049,435922,238308,197614,60,64,55
18,20,Bongaigaon,Rural,631813,321206,310607,356376,195960,160416,56,61,52
18,20,Bongaigaon,Urban,100826,52384,48442,79546,42348,37198,79,81,77
18,21,Chirang,Total,481818,244675,237143,266380,149017,117363,55,61,49
18,21,Chirang,Rural,446290,226394,219896,240546,134886,105660,54,60,48
18,21,Chirang,Urban,35528,18281,17247,25834,14131,11703,73,77,68
18,22,Kamrup,Total,1517202,779608,737594,962677,528117,434560,63,68,59
18,22,Kamrup,Rural,1375188,707337,667851,847747,466748,380999,62,66,57
18,22,Kamrup,Urban,142014,72271,69743,114930,61369,53561,81,85,77
18,23,Kamrup Metropolitan,Total,1260419,655630,604789,1010688,543202,467486,80,83,77
18,23,Kamrup Metropolitan,Rural,215587,110430,105157,145732,80629,65103,68,73,62
18,23,Kamrup Metropolitan,Urban,1044832,545200,499632,864956,462573,402383,83,85,81
18,24,Nalbari,Total,769919,395804,374115,542680,299224,243456,70,76,65
18,24,Nalbari,Rural,687368,353395,333973,473689,262380,211309,69,74,63
18,24,Nalbari,Urban,82551,42409,40142,68991,36844,32147,84,87,80
18,25,Baksa,Total,953773,484825,468948,589866,333856,256010,62,69,55
18,25,Baksa,Rural,941600,478577,463023,581783,329407,252376,62,69,55
18,25,Baksa,Urban,12173,6248,5925,8083,4449,3634,66,71,61
18,26,Darrang,Total,908090,472134,435956,489559,270036,219523,54,57,50
18,26,Darrang,Rural,852692,443448,409244,456046,252746,203300,53,57,50
18,26,Darrang,Urban,55398,28686,26712,33513,17290,16223,60,60,61
18,27,Udalguri,Total,832769,423617,409152,481867,271529,210338,58,64,51
18,27,Udalguri,Rural,795191,404467,390724,452410,255789,196621,57,63,50
18,27,Udalguri,Urban,37578,19150,18428,29457,15740,13717,78,82,74
19,0,WEST BENGAL,Total,91347736,46927389,44420347,62614556,34508159,28106397,69,74,63
19,0,WEST BENGAL,Rural,62213676,31904144,30309532,39898187,22298022,17600165,64,70,58
19,0,WEST BENGAL,Urban,29134060,15023245,14110815,22716369,12210137,10506232,78,81,74
19,1,Darjiling ,Total,1842034,934796,907238,1328218,723711,604507,72,77,67
19,1,Darjiling ,Rural,1123859,570997,552862,752287,420296,331991,67,74,60
19,1,Darjiling ,Urban,718175,363799,354376,575931,303415,272516,80,83,77
19,2,Jalpaiguri ,Total,3869675,1980068,1889607,2527018,1412065,1114953,65,71,59
19,2,Jalpaiguri ,Rural,2825001,1445791,1379210,1752822,995436,757386,62,69,55
19,2,Jalpaiguri ,Urban,1044674,534277,510397,774196,416629,357567,74,78,70
19,3,Koch Bihar ,Total,2822780,1453590,1369190,1879984,1045903,834081,67,72,61
19,3,Koch Bihar ,Rural,2533480,1306998,1226482,1643723,921851,721872,65,71,59
19,3,Koch Bihar ,Urban,289300,146592,142708,236261,124052,112209,82,85,79
19,4,Uttar Dinajpur,Total,3000849,1550219,1450630,1521933,872285,649648,51,56,45
19,4,Uttar Dinajpur,Rural,2638662,1361342,1277320,1262730,730783,531947,48,54,42
19,4,Uttar Dinajpur,Urban,362187,188877,173310,259203,141502,117701,72,75,68
19,5,Dakshin Dinajpur,Total,1670931,855104,815827,1102355,607992,494363,66,71,61
19,5,Dakshin Dinajpur,Rural,1434856,735688,699168,906370,505416,400954,63,69,57
19,5,Dakshin Dinajpur,Urban,236075,119416,116659,195985,102576,93409,83,86,80
19,6,Maldah ,Total,3997970,2061593,1936377,2136898,1182672,954226,53,57,49
19,6,Maldah ,Rural,3446056,1769978,1676078,1771627,985267,786360,51,56,47
19,6,Maldah ,Urban,551914,291615,260299,365271,197405,167866,66,68,64
19,7,Murshidabad ,Total,7102430,3629595,3472835,4134584,2223237,1911347,58,61,55
19,7,Murshidabad ,Rural,5697224,2917456,2779768,3254627,1749887,1504740,57,60,54
19,7,Murshidabad ,Urban,1405206,712139,693067,879957,473350,406607,63,66,59
19,8,Birbhum,Total,3502387,1791017,1711370,2175923,1214772,961151,62,68,56
19,8,Birbhum,Rural,3054019,1562479,1491540,1846090,1036645,809445,60,66,54
19,8,Birbhum,Urban,448368,228538,219830,329833,178127,151706,74,78,69
19,9,Barddhaman ,Total,7723663,3975356,3748307,5350197,2979074,2371123,69,75,63
19,9,Barddhaman ,Rural,4644079,2378398,2265681,3048014,1702982,1345032,66,72,59
19,9,Barddhaman ,Urban,3079584,1596958,1482626,2302183,1276092,1026091,75,80,69
19,10,Nadia ,Total,5168488,2655056,2513432,3524073,1906966,1617107,68,72,64
19,10,Nadia ,Rural,3730897,1922578,1808319,2386942,1302721,1084221,64,68,60
19,10,Nadia ,Urban,1437591,732478,705113,1137131,604245,532886,79,82,76
19,11,North Twenty Four Parganas,Total,10082852,5172138,4910714,7798722,4174559,3624163,77,81,74
19,11,North Twenty Four Parganas,Rural,4275724,2199110,2076614,2973608,1623012,1350596,70,74,65
19,11,North Twenty Four Parganas,Urban,5807128,2973028,2834100,4825114,2551547,2273567,83,86,80
19,12,Hugli ,Total,5520389,2819100,2701289,4140487,2250780,1889707,75,80,70
19,12,Hugli ,Rural,3388395,1723414,1664981,2421002,1331018,1089984,71,77,65
19,12,Hugli ,Urban,2131994,1095686,1036308,1719485,919762,799723,81,84,77
19,13,Bankura ,Total,3596292,1840504,1755788,2264013,1321794,942219,63,72,54
19,13,Bankura ,Rural,3295613,1686978,1608635,2028958,1193636,835322,62,71,52
19,13,Bankura ,Urban,300679,153526,147153,235055,128158,106897,78,83,73
19,14,Puruliya,Total,2927965,1497656,1430309,1656940,1021455,635485,57,68,44
19,14,Puruliya,Rural,2554584,1304820,1249764,1404686,876728,527958,55,67,42
19,14,Puruliya,Urban,373381,192836,180545,252254,144727,107527,68,75,60
19,15,Haora ,Total,4841638,2502453,2339185,3642617,1972282,1670335,75,79,71
19,15,Haora ,Rural,1776970,911800,865170,1277113,698122,578991,72,77,67
19,15,Haora ,Urban,3064668,1590653,1474015,2365504,1274160,1091344,77,80,74
19,16,Kolkata,Total,4486679,2362662,2124017,3648210,1966122,1682088,81,83,79
19,16,Kolkata,Urban,4486679,2362662,2124017,3648210,1966122,1682088,81,83,79
19,17,South  Twenty Four Parganas,Total,8153176,4182758,3970418,5639112,3120200,2518912,69,75,63
19,17,South  Twenty Four Parganas,Rural,6065179,3113964,2951215,4065797,2273552,1792245,67,73,61
19,17,South  Twenty Four Parganas,Urban,2087997,1068794,1019203,1573315,846648,726667,75,79,71
19,18,Paschim Medinipur,Total,5943300,3032630,2910670,4173522,2333679,1839843,70,77,63
19,18,Paschim Medinipur,Rural,5228308,2669136,2559172,3606955,2030548,1576407,69,76,62
19,18,Paschim Medinipur,Urban,714992,363494,351498,566567,303131,263436,79,83,75
19,19,Purba Medinipur ,Total,5094238,2631094,2463144,3969750,2178611,1791139,78,83,73
19,19,Purba Medinipur ,Rural,4500770,2323217,2177553,3494836,1920122,1574714,78,83,72
19,19,Purba Medinipur ,Urban,593468,307877,285591,474914,258489,216425,80,84,76
20,0,JHARKHAND,Total,32966238,16931688,16034550,18753660,11168649,7585011,57,66,47
20,0,JHARKHAND,Rural,25036946,12775468,12261478,12973765,7904318,5069447,52,62,41
20,0,JHARKHAND,Urban,7929292,4156220,3773072,5779895,3264331,2515564,73,79,67
20,1,Garhwa,Total,1322387,683984,638403,676951,417854,259097,51,61,41
20,1,Garhwa,Rural,1252709,647317,605392,630074,390645,239429,50,60,40
20,1,Garhwa,Urban,69678,36667,33011,46877,27209,19668,67,74,60
20,2,Chatra,Total,1042304,534209,508095,530491,314764,215727,51,59,42
20,2,Chatra,Rural,979406,500542,478864,486264,289228,197036,50,58,41
20,2,Chatra,Urban,62898,33667,29231,44227,25536,18691,70,76,64
20,3,Kodarma,Total,717169,367952,349217,402356,245268,157088,56,67,45
20,3,Kodarma,Rural,575783,294191,281592,306445,189984,116461,53,65,41
20,3,Kodarma,Urban,141386,73761,67625,95911,55284,40627,68,75,60
20,4,Giridih,Total,2445203,1258607,1186596,1298835,811140,487695,53,64,41
20,4,Giridih,Rural,2237300,1150160,1087140,1156202,731060,425142,52,64,39
20,4,Giridih,Urban,207903,108447,99456,142633,80080,62553,69,74,63
20,5,Deoghar,Total,1491879,776741,715138,815322,507395,307927,55,65,43
20,5,Deoghar,Rural,1233652,639693,593959,623336,397944,225392,51,62,38
20,5,Deoghar,Urban,258227,137048,121179,191986,109451,82535,74,80,68
20,6,Godda,Total,1311382,678504,632878,621012,388307,232705,47,57,37
20,6,Godda,Rural,1246998,644464,602534,575021,362223,212798,46,56,35
20,6,Godda,Urban,64384,34040,30344,45991,26084,19907,71,77,66
20,7,Sahibganj,Total,1150038,590390,559648,501630,300504,201126,44,51,36
20,7,Sahibganj,Rural,990592,506759,483833,399755,242076,157679,40,48,33
20,7,Sahibganj,Urban,159446,83631,75815,101875,58428,43447,64,70,57
20,8,Pakur,Total,899200,453101,446099,363178,214771,148407,40,47,33
20,8,Pakur,Rural,831718,418557,413161,325139,193659,131480,39,46,32
20,8,Pakur,Urban,67482,34544,32938,38039,21112,16927,56,61,51
20,9,Dhanbad,Total,2682662,1405847,1276815,1752787,1040335,712452,65,74,56
20,9,Dhanbad,Rural,1123246,581061,542185,662551,408333,254218,59,70,47
20,9,Dhanbad,Urban,1559416,824786,734630,1090236,632002,458234,70,77,62
20,10,Bokaro,Total,2061918,1076270,985648,1306234,783778,522456,63,73,53
20,10,Bokaro,Rural,1078585,556626,521959,595679,371114,224565,55,67,43
20,10,Bokaro,Urban,983333,519644,463689,710555,412664,297891,72,79,64
20,11,Lohardaga,Total,461738,232575,229163,263637,152509,111128,57,66,48
20,11,Lohardaga,Rural,404341,203260,201081,220929,129511,91418,55,64,45
20,11,Lohardaga,Urban,57397,29315,28082,42708,22998,19710,74,78,70
20,12,Purbi Singhbhum,Total,2291032,1175696,1115336,1526126,867608,658518,67,74,59
20,12,Purbi Singhbhum,Rural,1018352,514128,504224,555354,332236,223118,55,65,44
20,12,Purbi Singhbhum,Urban,1272680,661568,611112,970772,535372,435400,76,81,71
20,13,Palamu,Total,1936319,1003876,932443,1061012,641646,419366,55,64,45
20,13,Palamu,Rural,1710626,885444,825182,899272,549929,349343,53,62,42
20,13,Palamu,Urban,225693,118432,107261,161740,91717,70023,72,77,65
20,14,Latehar,Total,725673,369534,356139,363047,216790,146257,50,59,41
20,14,Latehar,Rural,674503,342804,331699,327822,196909,130913,49,57,39
20,14,Latehar,Urban,51170,26730,24440,35225,19881,15344,69,74,63
20,15,Hazaribagh,Total,1734005,891179,842826,1029418,607873,421545,59,68,50
20,15,Hazaribagh,Rural,1458681,747069,711612,821629,492385,329244,56,66,46
20,15,Hazaribagh,Urban,275324,144110,131214,207789,115488,92301,75,80,70
20,16,Ramgarh,Total,949159,494037,455122,605054,355949,249105,64,72,55
20,16,Ramgarh,Rural,530284,271961,258323,306615,183224,123391,58,67,48
20,16,Ramgarh,Urban,418875,222076,196799,298439,172725,125714,71,78,64
20,17,Dumka,Total,1321096,669240,651856,693005,421315,271690,52,63,42
20,17,Dumka,Rural,1230976,621661,609315,626088,383530,242558,51,62,40
20,17,Dumka,Urban,90120,47579,42541,66917,37785,29132,74,79,68
20,18,Jamtara,Total,790207,403450,386757,421757,259380,162377,53,64,42
20,18,Jamtara,Rural,714192,363597,350595,366664,227774,138890,51,63,40
20,18,Jamtara,Urban,76015,39853,36162,55093,31606,23487,72,79,65
20,19,Ranchi,Total,2912022,1493376,1418646,1946699,1107234,839465,67,74,59
20,19,Ranchi,Rural,1654682,838721,815961,971515,572402,399113,59,68,49
20,19,Ranchi,Urban,1257340,654655,602685,975184,534832,440352,78,82,73
20,20,Khunti,Total,530299,265939,264360,288340,168160,120180,54,63,45
20,20,Khunti,Rural,485195,243010,242185,255186,150192,104994,53,62,43
20,20,Khunti,Urban,45104,22929,22175,33154,17968,15186,74,78,68
20,21,Gumla,Total,1025656,514730,510926,573776,329528,244248,56,64,48
20,21,Gumla,Rural,959676,481006,478670,522673,302151,220522,54,63,46
20,21,Gumla,Urban,65980,33724,32256,51103,27377,23726,77,81,74
20,22,Simdega,Total,599813,299905,299908,343727,192394,151333,57,64,50
20,22,Simdega,Rural,556880,278048,278832,311708,175374,136334,56,63,49
20,22,Simdega,Urban,42933,21857,21076,32019,17020,14999,75,78,71
20,23,Pashchimi Singhbhum,Total,1501619,749314,752305,742809,448264,294545,49,60,39
20,23,Pashchimi Singhbhum,Rural,1283442,637398,646044,583866,359799,224067,45,56,35
20,23,Pashchimi Singhbhum,Urban,218177,111916,106261,158943,88465,70478,73,79,66
20,24,Saraikela-Kharsawan,Total,1063458,543232,520226,626457,375883,250574,59,69,48
20,24,Saraikela-Kharsawan,Rural,805127,407991,397136,443978,272636,171342,55,67,43
20,24,Saraikela-Kharsawan,Urban,258331,135241,123090,182479,103247,79232,71,76,64
21,0,ORISSA,Total,41947358,21201678,20745680,27112376,15326036,11786340,65,72,57
21,0,ORISSA,Rural,34951234,17584859,17366375,21669993,12341583,9328410,62,70,54
21,0,ORISSA,Urban,6996124,3616819,3379305,5442383,2984453,2457930,78,83,73
21,1,Bargarh,Total,1478833,748332,730501,994056,563095,430961,67,75,59
21,1,Bargarh,Rural,1329125,672004,657121,879695,500749,378946,66,75,58
21,1,Bargarh,Urban,149708,76328,73380,114361,62346,52015,76,82,71
21,2,Jharsuguda,Total,579499,297014,282485,405652,228715,176937,70,77,63
21,2,Jharsuguda,Rural,348339,176271,172068,231875,131262,100613,67,74,58
21,2,Jharsuguda,Urban,231160,120743,110417,173777,97453,76324,75,81,69
21,3,Sambalpur,Total,1044410,529424,514986,716410,401084,315326,69,76,61
21,3,Sambalpur,Rural,733021,369238,363783,478196,271053,207143,65,73,57
21,3,Sambalpur,Urban,311389,160186,151203,238214,130031,108183,77,81,72
21,4,Debagarh,Total,312164,158017,154147,199877,113907,85970,64,72,56
21,4,Debagarh,Rural,289814,146453,143361,183301,104800,78501,63,72,55
21,4,Debagarh,Urban,22350,11564,10786,16576,9107,7469,74,79,69
21,5,Sundargarh,Total,2080664,1055723,1024941,1357840,761538,596302,65,72,58
21,5,Sundargarh,Rural,1342031,669548,672483,787605,446024,341581,59,67,51
21,5,Sundargarh,Urban,738633,386175,352458,570235,315514,254721,77,82,72
21,6,Kendujhar,Total,1802777,907135,895642,1069023,616025,452998,59,68,51
21,6,Kendujhar,Rural,1549671,775397,774274,895252,517171,378081,58,67,49
21,6,Kendujhar,Urban,253106,131738,121368,173771,98854,74917,69,75,62
21,7,Mayurbhanj,Total,2513895,1253633,1260262,1392207,809654,582553,55,65,46
21,7,Mayurbhanj,Rural,2321091,1154992,1166099,1242182,728618,513564,54,63,44
21,7,Mayurbhanj,Urban,192804,98641,94163,150025,81036,68989,78,82,73
21,8,Baleshwar,Total,2317419,1184371,1133048,1647895,918407,729488,71,78,64
21,8,Baleshwar,Rural,2064357,1055059,1009298,1454944,814701,640243,70,77,63
21,8,Baleshwar,Urban,253062,129312,123750,192951,103706,89245,76,80,72
21,9,Bhadrak,Total,1506522,760591,745931,1106962,601565,505397,73,79,68
21,9,Bhadrak,Rural,1320766,665548,655218,975418,530040,445378,74,80,68
21,9,Bhadrak,Urban,185756,95043,90713,131544,71525,60019,71,75,66
21,10,Kendrapara,Total,1439891,717695,722196,1105385,589684,515701,77,82,71
21,10,Kendrapara,Rural,1356351,674904,681447,1038744,553933,484811,77,82,71
21,10,Kendrapara,Urban,83540,42791,40749,66641,35751,30890,80,84,76
21,11,Jagatsinghapur,Total,1136604,577699,558905,900104,488401,411703,79,85,74
21,11,Jagatsinghapur,Rural,1020710,516692,504018,807648,437288,370360,79,85,73
21,11,Jagatsinghapur,Urban,115894,61007,54887,92456,51113,41343,80,84,75
21,12,Cuttack,Total,2618708,1339153,1279555,1993561,1093224,900337,76,82,70
21,12,Cuttack,Rural,1886926,969975,916951,1383299,764856,618443,73,79,67
21,12,Cuttack,Urban,731782,369178,362604,610262,328368,281894,83,89,78
21,13,Jajapur,Total,1826275,926058,900217,1302292,714677,587615,71,77,65
21,13,Jajapur,Rural,1691264,856672,834592,1199274,658877,540397,71,77,65
21,13,Jajapur,Urban,135011,69386,65625,103018,55800,47218,76,80,72
21,14,Dhenkanal,Total,1192948,612597,580351,841988,471681,370307,71,77,64
21,14,Dhenkanal,Rural,1075714,551457,524257,746712,419810,326902,69,76,62
21,14,Dhenkanal,Urban,117234,61140,56094,95276,51871,43405,81,85,77
21,15,Anugul,Total,1271703,654898,616805,889122,502837,386285,70,77,63
21,15,Anugul,Rural,1065309,545781,519528,728347,412862,315485,68,76,61
21,15,Anugul,Urban,206394,109117,97277,160775,89975,70800,78,82,73
21,16,Nayagarh,Total,962215,502194,460021,681522,387632,293890,71,77,64
21,16,Nayagarh,Rural,882489,460626,421863,617601,352469,265132,70,77,63
21,16,Nayagarh,Urban,79726,41568,38158,63921,35163,28758,80,85,75
21,17,Khordha,Total,2246341,1166949,1079392,1771198,972327,798871,79,83,74
21,17,Khordha,Rural,1165620,595163,570457,865256,476715,388541,74,80,68
21,17,Khordha,Urban,1080721,571786,508935,905942,495612,410330,84,87,81
21,18,Puri,Total,1697983,865209,832774,1309170,716143,593027,77,83,71
21,18,Puri,Rural,1432537,727810,704727,1094584,600491,494093,76,83,70
21,18,Puri,Urban,265446,137399,128047,214586,115652,98934,81,84,77
21,19,Ganjam,Total,3520151,1777324,1742827,2244408,1283157,961251,64,72,55
21,19,Ganjam,Rural,2753588,1381051,1372537,1659800,960653,699147,60,70,51
21,19,Ganjam,Urban,766563,396273,370290,584608,322504,262104,76,81,71
21,20,Gajapati,Total,575880,282041,293839,267697,157330,110367,46,56,38
21,20,Gajapati,Rural,505354,246883,258471,217835,130316,87519,43,53,34
21,20,Gajapati,Urban,70526,35158,35368,49862,27014,22848,71,77,65
21,21,Kandhamal,Total,731952,359401,372551,407383,239270,168113,56,67,45
21,21,Kandhamal,Rural,659788,322988,336800,350743,208661,142082,53,65,42
21,21,Kandhamal,Urban,72164,36413,35751,56640,30609,26031,78,84,73
21,22,Baudh,Total,439917,220993,218924,276122,161440,114682,63,73,52
21,22,Baudh,Rural,419482,210507,208975,259955,152469,107486,62,72,51
21,22,Baudh,Urban,20435,10486,9949,16167,8971,7196,79,86,72
21,23,Subarnapur,Total,652107,332897,319210,428333,248893,179440,66,75,56
21,23,Subarnapur,Rural,602175,307204,294971,390978,227777,163201,65,74,55
21,23,Subarnapur,Urban,49932,25693,24239,37355,21116,16239,75,82,67
21,24,Balangir,Total,1648574,831349,817225,944254,559065,385189,57,67,47
21,24,Balangir,Rural,1451413,730017,721396,795185,476677,318508,55,65,44
21,24,Balangir,Urban,197161,101332,95829,149069,82388,66681,76,81,70
21,25,Nuapada,Total,606490,300307,306183,303559,184049,119510,50,61,39
21,25,Nuapada,Rural,572490,283130,289360,279552,170734,108818,49,60,38
21,25,Nuapada,Urban,34000,17177,16823,24007,13315,10692,71,78,64
21,26,Kalahandi,Total,1573054,785179,787875,818396,495187,323209,52,63,41
21,26,Kalahandi,Rural,1451130,722742,728388,728801,445435,283366,50,62,39
21,26,Kalahandi,Urban,121924,62437,59487,89595,49752,39843,73,80,67
21,27,Rayagada,Total,961959,469672,492287,417632,248859,168773,43,53,34
21,27,Rayagada,Rural,814203,394547,419656,313037,190583,122454,38,48,29
21,27,Rayagada,Urban,147756,75125,72631,104595,58276,46319,71,78,64
21,28,Nabarangapur,Total,1218762,604046,614716,490161,298693,191468,40,49,31
21,28,Nabarangapur,Rural,1131057,559933,571124,429046,265122,163924,38,47,29
21,28,Nabarangapur,Urban,87705,44113,43592,61115,33571,27544,70,76,63
21,29,Koraput,Total,1376934,677864,699070,579203,348447,230756,42,51,33
21,29,Koraput,Rural,1151528,563422,588106,415850,258634,157216,36,46,27
21,29,Koraput,Urban,225406,114442,110964,163353,89813,73540,72,78,66
21,30,Malkangiri,Total,612727,303913,308814,250964,151050,99914,41,50,32
21,30,Malkangiri,Rural,563891,278845,285046,219278,132803,86475,39,48,30
21,30,Malkangiri,Urban,48836,25068,23768,31686,18247,13439,65,73,57
22,0,CHHATTISGARH,Total,25540196,12827915,12712281,15598314,8962121,6636193,61,70,52
22,0,CHHATTISGARH,Rural,19603658,9792514,9811144,11173237,6520952,4652285,57,67,47
22,0,CHHATTISGARH,Urban,5936538,3035401,2901137,4425077,2441169,1983908,75,80,68
22,1,Koriya,Total,659039,334336,324703,404044,233924,170120,61,70,52
22,1,Koriya,Rural,453476,228004,225472,253385,148595,104790,56,65,46
22,1,Koriya,Urban,205563,106332,99231,150659,85329,65330,73,80,66
22,2,Surguja,Total,2361329,1195145,1166184,1216795,715863,500932,52,60,43
22,2,Surguja,Rural,2116312,1068423,1047889,1033604,614814,418790,49,58,40
22,2,Surguja,Urban,245017,126722,118295,183191,101049,82142,75,80,69
22,3,Jashpur,Total,852043,425085,426958,502105,284985,217120,59,67,51
22,3,Jashpur,Rural,776017,386603,389414,446004,254669,191335,57,66,49
22,3,Jashpur,Urban,76026,38482,37544,56101,30316,25785,74,79,69
22,4,Raigarh,Total,1493627,749439,744188,959866,547886,411980,64,73,55
22,4,Raigarh,Rural,1247346,623006,624340,774847,445619,329228,62,72,53
22,4,Raigarh,Urban,246281,126433,119848,185019,102267,82752,75,81,69
22,5,Korba,Total,1206563,612158,594405,760153,441565,318588,63,72,54
22,5,Korba,Rural,760360,380997,379363,429859,255037,174822,57,67,46
22,5,Korba,Urban,446203,231161,215042,330294,186528,143766,74,81,67
22,6,Janjgir - Champa,Total,1620632,816057,804575,1032847,602018,430829,64,74,54
22,6,Janjgir - Champa,Rural,1395433,701632,693801,870674,510950,359724,62,73,52
22,6,Janjgir - Champa,Urban,225199,114425,110774,162173,91068,71105,72,80,64
22,7,Bilaspur,Total,2662077,1349928,1312149,1618895,947829,671066,61,70,51
22,7,Bilaspur,Rural,1983255,1001592,981663,1112870,668268,444602,56,67,45
22,7,Bilaspur,Urban,678822,348336,330486,506025,279561,226464,75,80,69
22,8,Kabeerdham,Total,822239,411637,410602,422174,255189,166985,51,62,41
22,8,Kabeerdham,Rural,734894,367586,367308,364289,222840,141449,50,61,39
22,8,Kabeerdham,Urban,87345,44051,43294,57885,32349,25536,66,73,59
22,9,Rajnandgaon,Total,1537520,762170,775350,1024533,573441,451092,67,75,58
22,9,Rajnandgaon,Rural,1264980,625667,639313,815956,461185,354771,65,74,55
22,9,Rajnandgaon,Urban,272540,136503,136037,208577,112256,96321,77,82,71
22,10,Durg,Total,3343079,1681521,1661558,2328412,1302207,1026205,70,77,62
22,10,Durg,Rural,2058958,1026026,1032932,1345357,763404,581953,65,74,56
22,10,Durg,Urban,1284121,655495,628626,983055,538803,444252,77,82,71
22,11,Raipur,Total,4062160,2048856,2013304,2669362,1521582,1147780,66,74,57
22,11,Raipur,Rural,2579933,1288791,1291142,1569212,915676,653536,61,71,51
22,11,Raipur,Urban,1482227,760065,722162,1100150,605906,494244,74,80,68
22,12,Mahasamund,Total,1032275,511475,520800,644482,368907,275575,62,72,53
22,12,Mahasamund,Rural,912166,451269,460897,557788,321467,236321,61,71,51
22,12,Mahasamund,Urban,120109,60206,59903,86694,47440,39254,72,79,66
22,13,Dhamtari,Total,799199,397250,401949,551569,307536,244033,69,77,61
22,13,Dhamtari,Rural,650045,322819,327226,439388,246840,192548,68,76,59
22,13,Dhamtari,Urban,149154,74431,74723,112181,60696,51485,75,82,69
22,14,Uttar Bastar Kanker,Total,748593,372987,375606,462103,262099,200004,62,70,53
22,14,Uttar Bastar Kanker,Rural,671834,334805,337029,402432,230484,171948,60,69,51
22,14,Uttar Bastar Kanker,Urban,76759,38182,38577,59671,31615,28056,78,83,73
22,15,Bastar,Total,1411644,697359,714285,658587,387907,270680,47,56,38
22,15,Bastar,Rural,1218316,599653,618663,517571,310756,206815,42,52,33
22,15,Bastar,Urban,193328,97706,95622,141016,77151,63865,73,79,67
22,16,Narayanpur,Total,140206,70189,70017,58202,34574,23628,42,49,34
22,16,Narayanpur,Rural,118087,58775,59312,41764,25224,16540,35,43,28
22,16,Narayanpur,Urban,22119,11414,10705,16438,9350,7088,74,82,66
22,17,Dakshin Bastar Dantewada,Total,532791,263562,269229,194705,118785,75920,37,45,28
22,17,Dakshin Bastar Dantewada,Rural,436655,213450,223205,127926,80445,47481,29,38,21
22,17,Dakshin Bastar Dantewada,Urban,96136,50112,46024,66779,38340,28439,69,77,62
22,18,Bijapur,Total,255180,128761,126419,89480,55824,33656,35,43,27
22,18,Bijapur,Rural,225591,113416,112175,70311,44679,25632,31,39,23
22,18,Bijapur,Urban,29589,15345,14244,19169,11145,8024,65,73,56
23,0,MADHYA PRADESH,Total,72597565,37612920,34984645,43827193,25848137,17979056,60,69,51
23,0,MADHYA PRADESH,Rural,52537899,27142409,25395490,28991005,17549814,11441191,55,65,45
23,0,MADHYA PRADESH,Urban,20059666,10470511,9589155,14836188,8298323,6537865,74,79,68
23,1,Sheopur,Total,687952,361685,326267,332091,211228,120863,48,58,37
23,1,Sheopur,Rural,580695,305268,275427,264584,170969,93615,46,56,34
23,1,Sheopur,Urban,107257,56417,50840,67507,40259,27248,63,71,54
23,2,Morena,Total,1965137,1068364,896773,1200551,761687,438864,61,71,49
23,2,Morena,Rural,1494734,815177,679557,881111,569573,311538,59,70,46
23,2,Morena,Urban,470403,253187,217216,319440,192114,127326,68,76,59
23,3,Bhind,Total,1703562,926940,776622,1119675,693217,426458,66,75,55
23,3,Bhind,Rural,1270762,694793,575969,819368,514928,304440,64,74,53
23,3,Bhind,Urban,432800,232147,200653,300307,178289,122018,69,77,61
23,4,Gwalior,Total,2030543,1090647,939896,1384434,821315,563119,68,75,60
23,4,Gwalior,Rural,757803,409778,348025,432755,276641,156114,57,68,45
23,4,Gwalior,Urban,1272740,680869,591871,951679,544674,407005,75,80,69
23,5,Datia,Total,786375,419432,366943,497883,307131,190752,63,73,52
23,5,Datia,Rural,604199,323136,281063,371216,233818,137398,61,72,49
23,5,Datia,Urban,182176,96296,85880,126667,73313,53354,70,76,62
23,6,Shivpuri,Total,1725818,919405,806413,921055,587429,333626,53,64,41
23,6,Shivpuri,Rural,1430199,762988,667211,719960,470127,249833,50,62,37
23,6,Shivpuri,Urban,295619,156417,139202,201095,117302,83793,68,75,60
23,7,Tikamgarh,Total,1444920,759891,685029,764250,470142,294108,53,62,43
23,7,Tikamgarh,Rural,1195160,629148,566012,600851,375916,224935,50,60,40
23,7,Tikamgarh,Urban,249760,130743,119017,163399,94226,69173,65,72,58
23,8,Chhatarpur,Total,1762857,935906,826951,962827,585133,377694,55,63,46
23,8,Chhatarpur,Rural,1363604,725049,638555,686600,427261,259339,50,59,41
23,8,Chhatarpur,Urban,399253,210857,188396,276227,157872,118355,69,75,63
23,9,Panna,Total,1016028,532866,483162,565120,339312,225808,56,64,47
23,9,Panna,Rural,890707,466931,423776,476673,289043,187630,54,62,44
23,9,Panna,Urban,125321,65935,59386,88447,50269,38178,71,76,64
23,10,Sagar,Total,2378295,1254251,1124044,1571387,924603,646784,66,74,58
23,10,Sagar,Rural,1669346,882272,787074,1030180,622026,408154,62,71,52
23,10,Sagar,Urban,708949,371979,336970,541207,302577,238630,76,81,71
23,11,Damoh,Total,1263703,660478,603225,763448,456198,307250,60,69,51
23,11,Damoh,Rural,1013296,529316,483980,577089,351363,225726,57,66,47
23,11,Damoh,Urban,250407,131162,119245,186359,104835,81524,74,80,68
23,12,Satna,Total,2228619,1156734,1071885,1407024,824340,582684,63,71,54
23,12,Satna,Rural,1754318,907380,846938,1057957,626454,431503,60,69,51
23,12,Satna,Urban,474301,249354,224947,349067,197886,151181,74,79,67
23,13,Rewa,Total,2363744,1224918,1138826,1485242,873453,611789,63,71,54
23,13,Rewa,Rural,1968257,1017147,951110,1194392,708213,486179,61,70,51
23,13,Rewa,Urban,395487,207771,187716,290850,165240,125610,74,80,67
23,14,Umaria,Total,643579,329527,314052,366414,217458,148956,57,66,47
23,14,Umaria,Rural,533058,271972,261086,288148,172531,115617,54,63,44
23,14,Umaria,Urban,110521,57555,52966,78266,44927,33339,71,78,63
23,15,Neemuch,Total,825958,421640,404318,517361,314785,202576,63,75,50
23,15,Neemuch,Rural,580728,294487,286241,336594,211467,125127,58,72,44
23,15,Neemuch,Urban,245230,127153,118077,180767,103318,77449,74,81,66
23,16,Mandsaur,Total,1339832,681439,658393,848260,513012,335248,63,75,51
23,16,Mandsaur,Rural,1062470,539880,522590,640588,397342,243246,60,74,47
23,16,Mandsaur,Urban,277362,141559,135803,207672,115670,92002,75,82,68
23,17,Ratlam,Total,1454483,737365,717118,845276,498129,347147,58,68,48
23,17,Ratlam,Rural,1019563,515685,503878,521046,320602,200444,51,62,40
23,17,Ratlam,Urban,434920,221680,213240,324230,177527,146703,75,80,69
23,18,Ujjain,Total,1986597,1016432,970165,1266579,748661,517918,64,74,53
23,18,Ujjain,Rural,1207533,616168,591365,688130,428813,259317,57,70,44
23,18,Ujjain,Urban,779064,400264,378800,578449,319848,258601,74,80,68
23,19,Shajapur,Total,1512353,779900,732453,911619,556098,355521,60,71,49
23,19,Shajapur,Rural,1219002,628763,590239,704212,437815,266397,58,70,45
23,19,Shajapur,Urban,293351,151137,142214,207407,118283,89124,71,78,63
23,20,Dewas,Total,1563107,805212,757895,944968,565242,379726,60,70,50
23,20,Dewas,Rural,1111312,571248,540064,618361,380664,237697,56,67,44
23,20,Dewas,Urban,451795,233964,217831,326607,184578,142029,72,79,65
23,21,Dhar,Total,2184672,1114267,1070405,1111637,662619,449018,51,59,42
23,21,Dhar,Rural,1771557,896057,875500,824319,497313,327006,47,56,37
23,21,Dhar,Urban,413115,218210,194905,287318,165306,122012,70,76,63
23,22,Indore,Total,3272335,1700483,1571852,2358338,1324967,1033371,72,78,66
23,22,Indore,Rural,848023,436559,411464,510856,309032,201824,60,71,49
23,22,Indore,Urban,2424312,1263924,1160388,1847482,1015935,831547,76,80,72
23,23,West Nimar,Total,1872413,953617,918796,1009868,592712,417156,54,62,45
23,23,West Nimar,Rural,1573458,799788,773670,792767,472749,320018,50,59,41
23,23,West Nimar,Urban,298955,153829,145126,217101,119963,97138,73,78,67
23,24,Barwani,Total,1385659,699578,686081,564852,323852,241000,41,46,35
23,24,Barwani,Rural,1181786,595241,586545,426016,246868,179148,36,41,31
23,24,Barwani,Urban,203873,104337,99536,138836,76984,61852,68,74,62
23,25,Rajgarh,Total,1546541,791038,755503,827898,505443,322455,54,64,43
23,25,Rajgarh,Rural,1269973,649066,620907,640190,398592,241598,50,61,39
23,25,Rajgarh,Urban,276568,141972,134596,187708,106851,80857,68,75,60
23,26,Vidisha,Total,1458212,768799,689413,884829,527959,356870,61,69,52
23,26,Vidisha,Rural,1118583,591277,527306,640056,390895,249161,57,66,47
23,26,Vidisha,Urban,339629,177522,162107,244773,137064,107709,72,77,66
23,27,Bhopal,Total,2368145,1239378,1128767,1706846,949856,756990,72,77,67
23,27,Bhopal,Rural,453806,237717,216089,265335,159798,105537,58,67,49
23,27,Bhopal,Urban,1914339,1001661,912678,1441511,790058,651453,75,79,71
23,28,Sehore,Total,1311008,683703,627305,793710,479009,314701,61,70,50
23,28,Sehore,Rural,1062637,554528,508109,614603,378621,235982,58,68,46
23,28,Sehore,Urban,248371,129175,119196,179107,100388,78719,72,78,66
23,29,Raisen,Total,1331699,701114,630585,837567,490921,346646,63,70,55
23,29,Raisen,Rural,1028202,540599,487603,621404,367987,253417,60,68,52
23,29,Raisen,Urban,303497,160515,142982,216163,122934,93229,71,77,65
23,30,Betul,Total,1575247,799721,775526,959429,543654,415775,61,68,54
23,30,Betul,Rural,1266183,640809,625374,716486,411559,304927,57,64,49
23,30,Betul,Urban,309064,158912,150152,242943,132095,110848,79,83,74
23,31,Harda,Total,570302,295208,275094,361381,209819,151562,63,71,55
23,31,Harda,Rural,450936,233616,217320,268204,158834,109370,59,68,50
23,31,Harda,Urban,119366,61592,57774,93177,50985,42192,78,83,73
23,32,Hoshangabad,Total,1240975,648970,592005,826057,480781,345276,67,74,58
23,32,Hoshangabad,Rural,851126,445388,405738,520859,311347,209512,61,70,52
23,32,Hoshangabad,Urban,389849,203582,186267,305198,169434,135764,78,83,73
23,33,Katni,Total,1291684,663064,628620,812195,476322,335873,63,72,53
23,33,Katni,Rural,1028149,526100,502049,610379,364773,245606,59,69,49
23,33,Katni,Urban,263535,136964,126571,201816,111549,90267,77,81,71
23,34,Jabalpur,Total,2460714,1278448,1182266,1792386,1005618,786768,73,79,67
23,34,Jabalpur,Rural,1021937,526558,495379,651487,380879,270608,64,72,55
23,34,Jabalpur,Urban,1438777,751890,686887,1140899,624739,516160,79,83,75
23,35,Narsimhapur,Total,1092141,569618,522523,731594,422820,308774,67,74,59
23,35,Narsimhapur,Rural,888536,463386,425150,572576,335500,237076,64,72,56
23,35,Narsimhapur,Urban,203605,106232,97373,159018,87320,71698,78,82,74
23,36,Dindori,Total,704218,351344,352874,391230,230562,160668,56,66,46
23,36,Dindori,Rural,671890,334816,337074,366955,217068,149887,55,65,44
23,36,Dindori,Urban,32328,16528,15800,24275,13494,10781,75,82,68
23,37,Mandla,Total,1053522,525495,528027,620481,359137,261344,59,68,49
23,37,Mandla,Rural,923309,459392,463917,517964,304017,213947,56,66,46
23,37,Mandla,Urban,130213,66103,64110,102517,55120,47397,79,83,74
23,38,Chhindwara,Total,2090306,1063302,1027004,1316324,747981,568343,63,70,55
23,38,Chhindwara,Rural,1585177,805319,779858,925156,535513,389643,58,66,50
23,38,Chhindwara,Urban,505129,257983,247146,391168,212468,178700,77,82,72
23,39,Seoni,Total,1378876,694916,683960,878051,494512,383539,64,71,56
23,39,Seoni,Rural,1215000,611435,603565,746668,424170,322498,61,69,53
23,39,Seoni,Urban,163876,83481,80395,131383,70342,61041,80,84,76
23,40,Balaghat,Total,1701156,841794,859362,1169938,641551,528387,69,76,61
23,40,Balaghat,Rural,1456435,719358,737077,979818,540372,439446,67,75,60
23,40,Balaghat,Urban,244721,122436,122285,190120,101179,88941,78,83,73
23,41,Guna,Total,1240938,649591,591347,676580,416178,260402,55,64,44
23,41,Guna,Rural,928171,486071,442100,464660,293735,170925,50,60,39
23,41,Guna,Urban,312767,163520,149247,211920,122443,89477,68,75,60
23,42,Ashoknagar,Total,844979,444651,400328,480957,299409,181548,57,67,45
23,42,Ashoknagar,Rural,691233,364078,327155,376044,238496,137548,54,66,42
23,42,Ashoknagar,Urban,153746,80573,73173,104913,60913,44000,68,76,60
23,43,Shahdol,Total,1064989,541208,523781,622770,361692,261078,58,67,50
23,43,Shahdol,Rural,845633,427688,417945,458326,269996,188330,54,63,45
23,43,Shahdol,Urban,219356,113520,105836,164444,91696,72748,75,81,69
23,44,Anuppur,Total,749521,379496,370025,446611,261346,185265,60,69,50
23,44,Anuppur,Rural,544229,272451,271778,298566,176216,122350,55,65,45
23,44,Anuppur,Urban,205292,107045,98247,148045,85130,62915,72,80,64
23,45,Sidhi,Total,1126515,577091,549424,619768,366004,253764,55,63,46
23,45,Sidhi,Rural,1033407,528431,504976,555608,329372,226236,54,62,45
23,45,Sidhi,Urban,93108,48660,44448,64160,36632,27528,69,75,62
23,46,Singrauli,Total,1178132,614885,563247,607268,375260,232008,52,61,41
23,46,Singrauli,Rural,951304,494152,457152,454773,284570,170203,48,58,37
23,46,Singrauli,Urban,226828,120733,106095,152495,90690,61805,67,75,58
23,47,Jhabua,Total,1024091,514830,509261,362791,222609,140182,35,43,28
23,47,Jhabua,Rural,932086,467326,464760,295846,185352,110494,32,40,24
23,47,Jhabua,Urban,92005,47504,44501,66945,37257,29688,73,78,67
23,48,Alirajpur,Total,728677,362748,365929,217624,126261,91363,30,35,25
23,48,Alirajpur,Rural,671596,333739,337857,177987,104474,73513,27,31,22
23,48,Alirajpur,Urban,57081,29009,28072,39637,21787,17850,69,75,64
23,49,East Nimar,Total,1309443,673491,635952,747032,442844,304188,57,66,48
23,49,East Nimar,Rural,1050067,540408,509659,553642,337659,215983,53,62,42
23,49,East Nimar,Urban,259376,133083,126293,193390,105185,88205,75,79,70
23,50,Burhanpur,Total,756993,388040,368953,415717,237866,177851,55,61,48
23,50,Burhanpur,Rural,496724,254470,242254,233640,138491,95149,47,54,39
23,50,Burhanpur,Urban,260269,133570,126699,182077,99375,82702,70,74,65
24,0,GUJARAT,Total,60383628,31482282,28901346,41948677,23995500,17953177,69,76,62
24,0,GUJARAT,Rural,34670817,17802975,16867842,21896928,12756737,9140191,63,72,54
24,0,GUJARAT,Urban,25712811,13679307,12033504,20051749,11238763,8812986,78,82,73
24,1,Kachchh,Total,2090313,1096343,993970,1274242,753032,521210,61,69,52
24,1,Kachchh,Rural,1364472,714387,650085,756239,458510,297729,55,64,46
24,1,Kachchh,Urban,725841,381956,343885,518003,294522,223481,71,77,65
24,2,Banas Kantha,Total,3116045,1609148,1506897,1737654,1068813,668841,56,66,44
24,2,Banas Kantha,Rural,2702668,1393278,1309390,1444152,899307,544845,53,65,42
24,2,Banas Kantha,Urban,413377,215870,197507,293502,169506,123996,71,79,63
24,3,Patan,Total,1342746,694062,648684,854764,504737,350027,64,73,54
24,3,Patan,Rural,1061713,547926,513787,643595,386223,257372,61,70,50
24,3,Patan,Urban,281033,146136,134897,211169,118514,92655,75,81,69
24,4,Mahesana,Total,2027727,1053337,974390,1516781,854432,662349,75,81,68
24,4,Mahesana,Rural,1513656,783612,730044,1101657,625674,475983,73,80,65
24,4,Mahesana,Urban,514071,269725,244346,415124,228758,186366,81,85,76
24,5,Sabar Kantha,Total,2427346,1244491,1182855,1601010,932942,668068,66,75,56
24,5,Sabar Kantha,Rural,2064318,1056640,1007678,1327311,780987,546324,64,74,54
24,5,Sabar Kantha,Urban,363028,187851,175177,273699,151955,121744,75,81,69
24,6,Gandhinagar,Total,1387478,722459,665019,1053415,595432,457983,76,82,69
24,6,Gandhinagar,Rural,787949,407044,380905,575659,330618,245041,73,81,64
24,6,Gandhinagar,Urban,599529,315415,284114,477756,264814,212942,80,84,75
24,7,Ahmadabad,Total,7208200,3787050,3421150,5551238,3101903,2449335,77,82,72
24,7,Ahmadabad,Rural,1149436,595094,554342,720512,434902,285610,63,73,52
24,7,Ahmadabad,Urban,6058764,3191956,2866808,4830726,2667001,2163725,80,84,75
24,8,Surendranagar,Total,1755873,910266,845607,1113674,656290,457384,63,72,54
24,8,Surendranagar,Rural,1258880,649640,609240,745909,447427,298482,59,69,49
24,8,Surendranagar,Urban,496993,260626,236367,367765,208863,158902,74,80,67
24,9,Rajkot,Total,3799770,1975131,1824639,2774740,1548521,1226219,73,78,67
24,9,Rajkot,Rural,1591188,817667,773521,1066461,608635,457826,67,74,59
24,9,Rajkot,Urban,2208582,1157464,1051118,1708279,939886,768393,77,81,73
24,10,Jamnagar,Total,2159130,1114360,1044770,1417294,807397,609897,66,72,58
24,10,Jamnagar,Rural,1188485,609898,578587,728887,423418,305469,61,69,53
24,10,Jamnagar,Urban,970645,504462,466183,688407,383979,304428,71,76,65
24,11,Porbandar,Total,586062,300967,285095,400196,226004,174192,68,75,61
24,11,Porbandar,Rural,300236,153616,146620,186294,107776,78518,62,70,54
24,11,Porbandar,Urban,285826,147351,138475,213902,118228,95674,75,80,69
24,12,Junagadh,Total,2742291,1404506,1337785,1876671,1069199,807472,68,76,60
24,12,Junagadh,Rural,1836049,939954,896095,1201067,696377,504690,65,74,56
24,12,Junagadh,Urban,906242,464552,441690,675604,372822,302782,75,80,69
24,13,Amreli,Total,1513614,770651,742963,1001768,557060,444708,66,72,60
24,13,Amreli,Rural,1127808,572526,555282,715725,400360,315365,63,70,57
24,13,Amreli,Urban,385806,198125,187681,286043,156700,129343,74,79,69
24,14,Bhavnagar,Total,2877961,1490465,1387496,1927573,1115148,812425,67,75,59
24,14,Bhavnagar,Rural,1697808,869714,828094,1055489,622782,432707,62,72,52
24,14,Bhavnagar,Urban,1180153,620751,559402,872084,492366,379718,74,79,68
24,15,Anand,Total,2090276,1088253,1002023,1584180,893559,690621,76,82,69
24,15,Anand,Rural,1456483,759314,697169,1072940,615640,457300,74,81,66
24,15,Anand,Urban,633793,328939,304854,511240,277919,233321,81,84,77
24,16,Kheda,Total,2298934,1187098,1111836,1704430,971528,732902,74,82,66
24,16,Kheda,Rural,1775716,916604,859112,1291554,745609,545945,73,81,64
24,16,Kheda,Urban,523218,270494,252724,412876,225919,186957,79,84,74
24,17,Panch Mahals,Total,2388267,1227805,1160462,1474896,879648,595248,62,72,51
24,17,Panch Mahals,Rural,2053832,1054325,999507,1217511,737817,479694,59,70,48
24,17,Panch Mahals,Urban,334435,173480,160955,257385,141831,115554,77,82,72
24,18,Dohad,Total,2126558,1070843,1055715,1044494,622477,422017,49,58,40
24,18,Dohad,Rural,1935463,973281,962182,907216,546867,360349,47,56,37
24,18,Dohad,Urban,191095,97562,93533,137278,75610,61668,72,77,66
24,19,Vadodara,Total,4157568,2150229,2007339,2990876,1664022,1326854,72,77,66
24,19,Vadodara,Rural,2097791,1078609,1019182,1288732,747096,541636,61,69,53
24,19,Vadodara,Urban,2059777,1071620,988157,1702144,916926,785218,83,86,79
24,20,Narmada,Total,590379,301270,289109,377542,216755,160787,64,72,56
24,20,Narmada,Rural,528765,269709,259056,328354,190131,138223,62,70,53
24,20,Narmada,Urban,61614,31561,30053,49188,26624,22564,80,84,75
24,21,Bharuch,Total,1550822,805945,744877,1145960,636516,509444,74,79,68
24,21,Bharuch,Rural,1022413,527984,494429,724865,406644,318221,71,77,64
24,21,Bharuch,Urban,528409,277961,250448,421095,229872,191223,80,83,76
24,22,The Dangs,Total,226769,112976,113793,143908,78957,64951,63,70,57
24,22,The Dangs,Rural,202074,100868,101206,124229,68869,55360,61,68,55
24,22,The Dangs,Urban,24695,12108,12587,19679,10088,9591,80,83,76
24,23,Navsari,Total,1330711,678423,652288,1018311,550269,468042,77,81,72
24,23,Navsari,Rural,921599,465048,456551,687613,370497,317116,75,80,69
24,23,Navsari,Urban,409112,213375,195737,330698,179772,150926,81,84,77
24,24,Valsad,Total,1703068,884064,819004,1211437,671901,539536,71,76,66
24,24,Valsad,Rural,1068993,541364,527629,686431,378677,307754,64,70,58
24,24,Valsad,Urban,634075,342700,291375,525006,293224,231782,83,86,80
24,25,Surat,Total,6079231,3399742,2679489,4651812,2743118,1908694,77,81,71
24,25,Surat,Rural,1235509,642827,592682,859263,482832,376431,70,75,64
24,25,Surat,Urban,4843722,2756915,2086807,3792549,2260286,1532263,78,82,73
24,26,Tapi,Total,806489,402398,404091,499811,275840,223971,62,69,55
24,26,Tapi,Rural,727513,362046,365467,439263,243062,196201,60,67,54
24,26,Tapi,Urban,78976,40352,38624,60548,32778,27770,77,81,72
25,0,DAMAN & DIU,Total,242911,150100,92811,188974,124911,64063,78,83,69
25,0,DAMAN & DIU,Rural,60331,32317,28014,43281,25621,17660,72,79,63
25,0,DAMAN & DIU,Urban,182580,117783,64797,145693,99290,46403,80,84,72
25,1,Diu,Total,52056,25639,26417,38114,20387,17727,73,80,67
25,1,Diu,Rural,28080,14020,14060,18156,10252,7904,65,73,56
25,1,Diu,Urban,23976,11619,12357,19958,10135,9823,83,87,79
25,2,Daman,Total,190855,124461,66394,150860,104524,46336,79,84,70
25,2,Daman,Rural,32251,18297,13954,25125,15369,9756,78,84,70
25,2,Daman,Urban,158604,106164,52440,125735,89155,36580,79,84,70
26,0,DADRA & NAGAR HAVELI,Total,342853,193178,149675,228028,144916,83112,67,75,56
26,0,DADRA & NAGAR HAVELI,Rural,183024,98250,84774,102355,65782,36573,56,67,43
26,0,DADRA & NAGAR HAVELI,Urban,159829,94928,64901,125673,79134,46539,79,83,72
26,1,Dadra & Nagar Haveli,Total,342853,193178,149675,228028,144916,83112,67,75,56
26,1,Dadra & Nagar Haveli,Rural,183024,98250,84774,102355,65782,36573,56,67,43
26,1,Dadra & Nagar Haveli,Urban,159829,94928,64901,125673,79134,46539,79,83,72
27,0,MAHARASHTRA,Total,112372972,58361397,54011575,82512225,46294041,36218184,73,79,67
27,0,MAHARASHTRA,Rural,61545441,31593580,29951861,41703097,23870653,17832444,68,76,60
27,0,MAHARASHTRA,Urban,50827531,26767817,24059714,40809128,22423388,18385740,80,84,76
27,1,Nandurbar,Total,1646177,834866,811311,891991,514802,377189,54,62,46
27,1,Nandurbar,Rural,1370995,689337,681658,683673,397627,286046,50,58,42
27,1,Nandurbar,Urban,275182,145529,129653,208318,117175,91143,76,81,70
27,2,Dhule,Total,2048781,1055669,993112,1333571,756813,576758,65,72,58
27,2,Dhule,Rural,1477034,759962,717072,884493,513869,370624,60,68,52
27,2,Dhule,Urban,571747,295707,276040,449078,242944,206134,79,82,75
27,3,Jalgaon,Total,4224442,2197835,2026607,2958409,1686370,1272039,70,77,63
27,3,Jalgaon,Rural,2880984,1498712,1382272,1915681,1115396,800285,66,74,58
27,3,Jalgaon,Urban,1343458,699123,644335,1042728,570974,471754,78,82,73
27,4,Buldana,Total,2588039,1342152,1245887,1858169,1057459,800710,72,79,64
27,4,Buldana,Rural,2038650,1058620,980030,1430632,825276,605356,70,78,62
27,4,Buldana,Urban,549389,283532,265857,427537,232183,195354,78,82,73
27,5,Akola,Total,1818617,936226,882391,1411747,768925,642822,78,82,73
27,5,Akola,Rural,1096768,566172,530596,827526,459359,368167,75,81,69
27,5,Akola,Urban,721849,370054,351795,584221,309566,274655,81,84,78
27,6,Washim,Total,1196714,621228,575486,857270,490662,366608,72,79,64
27,6,Washim,Rural,985058,512379,472679,694527,402554,291973,71,79,62
27,6,Washim,Urban,211656,108849,102807,162743,88108,74635,77,81,73
27,7,Amravati,Total,2887826,1482845,1404981,2283354,1230400,1052954,79,83,75
27,7,Amravati,Rural,1851134,951695,899439,1420646,776535,644111,77,82,72
27,7,Amravati,Urban,1036692,531150,505542,862708,453865,408843,83,85,81
27,8,Wardha,Total,1296157,665925,630232,1021869,554496,467373,79,83,74
27,8,Wardha,Rural,875284,450588,424696,666587,366429,300158,76,81,71
27,8,Wardha,Urban,420873,215337,205536,355282,188067,167215,84,87,81
27,9,Nagpur,Total,4653171,2388558,2264613,3734192,2004798,1729394,80,84,76
27,9,Nagpur,Rural,1474977,759653,715324,1088170,603025,485145,74,79,68
27,9,Nagpur,Urban,3178194,1628905,1549289,2646022,1401773,1244249,83,86,80
27,10,Bhandara,Total,1198810,604371,594439,916010,504041,411969,76,83,69
27,10,Bhandara,Rural,965053,486423,478630,720834,400910,319924,75,82,67
27,10,Bhandara,Urban,233757,117948,115809,195176,103131,92045,83,87,79
27,11,Gondiya,Total,1322331,662524,659807,1013144,554230,458914,77,84,70
27,11,Gondiya,Rural,1096631,548739,547892,825515,454969,370546,75,83,68
27,11,Gondiya,Urban,225700,113785,111915,187629,99261,88368,83,87,79
27,12,Gadchiroli,Total,1071795,542813,528982,674958,388211,286747,63,72,54
27,12,Gadchiroli,Rural,953858,482740,471118,581025,337275,243750,61,70,52
27,12,Gadchiroli,Urban,117937,60073,57864,93933,50936,42997,80,85,74
27,13,Chandrapur,Total,2194262,1120316,1073946,1602823,891925,710898,73,80,66
27,13,Chandrapur,Rural,1424424,724040,700384,978553,553598,424955,69,76,61
27,13,Chandrapur,Urban,769838,396276,373562,624270,338327,285943,81,85,77
27,14,Yavatmal,Total,2775457,1425593,1349864,1981151,1114590,866561,71,78,64
27,14,Yavatmal,Rural,2176252,1119551,1056701,1494772,855807,638965,69,76,60
27,14,Yavatmal,Urban,599205,306042,293163,486379,258783,227596,81,85,78
27,15,Nanded,Total,3356566,1732567,1623999,2240609,1297915,942694,67,75,58
27,15,Nanded,Rural,2442734,1259335,1183399,1564313,922901,641412,64,73,54
27,15,Nanded,Urban,913832,473232,440600,676296,375014,301282,74,79,68
27,16,Hingoli,Total,1178973,609386,569587,773957,453721,320236,66,74,56
27,16,Hingoli,Rural,1000102,517145,482957,641569,380889,260680,64,74,54
27,16,Hingoli,Urban,178871,92241,86630,132388,72832,59556,74,79,69
27,17,Parbhani,Total,1835982,946185,889797,1191610,694878,496732,65,73,56
27,17,Parbhani,Rural,1266112,653347,612765,783915,469046,314869,62,72,51
27,17,Parbhani,Urban,569870,292838,277032,407695,225832,181863,72,77,66
27,18,Jalna,Total,1958483,1015116,943367,1234433,735402,499031,63,72,53
27,18,Jalna,Rural,1581251,819934,761317,960165,582884,377281,61,71,50
27,18,Jalna,Urban,377232,195182,182050,274268,152518,121750,73,78,67
27,19,Aurangabad,Total,3695928,1928156,1767772,2556154,1472313,1083841,69,76,61
27,19,Aurangabad,Rural,2079327,1083408,995919,1319157,790188,528969,63,73,53
27,19,Aurangabad,Urban,1616601,844748,771853,1236997,682125,554872,77,81,72
27,20,Nashik,Total,6109052,3164261,2944791,4294045,2408876,1885169,70,76,64
27,20,Nashik,Rural,3510885,1807906,1702979,2260407,1299728,960679,64,72,56
27,20,Nashik,Urban,2598167,1356355,1241812,2033638,1109148,924490,78,82,74
27,21,Thane,Total,11054131,5879387,5174744,8442935,4748769,3694166,76,81,71
27,21,Thane,Rural,2551037,1305429,1245608,1565938,906084,659854,61,69,53
27,21,Thane,Urban,8503094,4573958,3929136,6876997,3842685,3034312,81,84,77
27,22,Mumbai Suburban,Total,9332481,5025165,4307316,7685917,4304754,3381163,82,86,78
27,22,Mumbai Suburban,Urban,9332481,5025165,4307316,7685917,4304754,3381163,82,86,78
27,23,Mumbai,Total,3145966,1711650,1434316,2551669,1423020,1128649,81,83,79
27,23,Mumbai,Urban,3145966,1711650,1434316,2551669,1423020,1128649,81,83,79
27,24,Raigarh,Total,2635394,1348089,1287305,1967079,1085635,881444,75,81,68
27,24,Raigarh,Rural,1662585,837593,824992,1173845,653823,520022,71,78,63
27,24,Raigarh,Urban,972809,510496,462313,793234,431812,361422,82,85,78
27,25,Pune,Total,9426959,4936362,4490597,7288517,4048650,3239867,77,82,72
27,25,Pune,Rural,3687243,1913777,1773466,2640849,1505089,1135760,72,79,64
27,25,Pune,Urban,5739716,3022585,2717131,4647668,2543561,2104107,81,84,77
27,26,Ahmadnagar,Total,4543083,2348802,2194281,3213330,1826412,1386918,71,78,63
27,26,Ahmadnagar,Rural,3630012,1877105,1752907,2492690,1435315,1057375,69,76,60
27,26,Ahmadnagar,Urban,913071,471697,441374,720640,391097,329543,79,83,75
27,27,Bid,Total,2585962,1352468,1233494,1648473,975401,673072,64,72,55
27,27,Bid,Rural,2071277,1085245,986032,1269798,765101,504697,61,71,51
27,27,Bid,Urban,514685,267223,247462,378675,210300,168375,74,79,68
27,28,Latur,Total,2455543,1276262,1179281,1697454,972062,725392,69,76,62
27,28,Latur,Rural,1830085,951687,878398,1226787,711932,514855,67,75,59
27,28,Latur,Urban,625458,324575,300883,470667,260130,210537,75,80,70
27,29,Osmanabad,Total,1660311,864674,795637,1115057,645792,469265,67,75,59
27,29,Osmanabad,Rural,1378713,718804,659909,904028,528916,375112,66,74,57
27,29,Osmanabad,Urban,281598,145870,135728,211029,116876,94153,75,80,69
27,30,Solapur,Total,4315527,2233778,2081749,2950155,1689027,1261128,68,76,61
27,30,Solapur,Rural,2917088,1522647,1394441,1905128,1114374,790754,65,73,57
27,30,Solapur,Urban,1398439,711131,687308,1045027,574653,470374,75,81,68
27,31,Satara,Total,3003922,1512524,1491398,2270142,1242224,1027918,76,82,69
27,31,Satara,Rural,2433694,1220901,1212793,1806700,995134,811566,74,82,67
27,31,Satara,Urban,570228,291623,278605,463442,247090,216352,81,85,78
27,32,Ratnagiri,Total,1612672,759703,852969,1206058,624144,581914,75,82,68
27,32,Ratnagiri,Rural,1349062,628760,720302,983497,510562,472935,73,81,66
27,32,Ratnagiri,Urban,263610,130943,132667,222561,113582,108979,84,87,82
27,33,Sindhudurg,Total,848868,416695,432173,675218,356719,318499,80,86,74
27,33,Sindhudurg,Rural,741870,362681,379189,583992,309470,274522,79,85,72
27,33,Sindhudurg,Urban,106998,54014,52984,91226,47249,43977,85,87,83
27,34,Kolhapur,Total,3874015,1983274,1890741,2884130,1615767,1268363,74,81,67
27,34,Kolhapur,Rural,2644119,1349832,1294287,1890514,1077912,812602,71,80,63
27,34,Kolhapur,Urban,1229896,633442,596454,993616,537855,455761,81,85,76
27,35,Sangli,Total,2820575,1435972,1384603,2086625,1154838,931787,74,80,67
27,35,Sangli,Rural,2101143,1069433,1031710,1517171,848676,668495,72,79,65
27,35,Sangli,Urban,719432,366539,352893,569454,306162,263292,79,84,75
28,0,ANDHRA PRADESH,Total,84665533,42509881,42155652,51438510,28759782,22678728,61,68,54
28,0,ANDHRA PRADESH,Rural,56311788,28219760,28092028,30850648,17705396,13145252,55,63,47
28,0,ANDHRA PRADESH,Urban,28353745,14290121,14063624,20587862,11054386,9533476,73,77,68
28,1,Adilabad,Total,2737738,1366964,1370774,1503106,864990,638116,55,63,47
28,1,Adilabad,Rural,1979912,983653,996259,978472,573229,405243,49,58,41
28,1,Adilabad,Urban,757826,383311,374515,524634,291761,232873,69,76,62
28,2,Nizamabad,Total,2552073,1252191,1299882,1421759,809721,612038,56,65,47
28,2,Nizamabad,Rural,1964273,959801,1004472,1009097,586480,422617,51,61,42
28,2,Nizamabad,Urban,587800,292390,295410,412662,223241,189421,70,76,64
28,3,Karimnagar,Total,3811738,1897068,1914670,2263247,1292858,970389,59,68,51
28,3,Karimnagar,Rural,2817507,1396595,1420912,1554007,901472,652535,55,65,46
28,3,Karimnagar,Urban,994231,500473,493758,709240,391386,317854,71,78,64
28,4,Medak,Total,3031877,1524187,1507690,1677732,975710,702022,55,64,47
28,4,Medak,Rural,2303756,1153476,1150280,1164819,691418,473401,51,60,41
28,4,Medak,Urban,728121,370711,357410,512913,284292,228621,70,77,64
28,5,Hyderabad,Total,4010238,2064359,1945879,2906923,1540195,1366728,72,75,70
28,5,Hyderabad,Urban,4010238,2064359,1945879,2906923,1540195,1366728,72,75,70
28,6,Rangareddy,Total,5296396,2708694,2587702,3669033,2018557,1650476,69,75,64
28,6,Rangareddy,Rural,1572032,798623,773409,854133,504075,350058,54,63,45
28,6,Rangareddy,Urban,3724364,1910071,1814293,2814900,1514482,1300418,76,79,72
28,7,Mahbubnagar,Total,4042191,2046247,1995944,1984586,1183860,800726,49,58,40
28,7,Mahbubnagar,Rural,3435768,1738901,1696867,1559065,948125,610940,45,55,36
28,7,Mahbubnagar,Urban,606423,307346,299077,425521,235735,189786,70,77,63
28,8,Nalgonda,Total,3483648,1758061,1725587,2035177,1178956,856221,58,67,50
28,8,Nalgonda,Rural,2821905,1426255,1395650,1543924,912615,631309,55,64,45
28,8,Nalgonda,Urban,661743,331806,329937,491253,266341,224912,74,80,68
28,9,Warangal,Total,3522644,1766257,1756387,2116037,1211953,904084,60,69,51
28,9,Warangal,Rural,2524498,1264803,1259695,1372364,804276,568088,54,64,45
28,9,Warangal,Urban,998146,501454,496692,743673,407677,335996,75,81,68
28,10,Khammam,Total,2798214,1391936,1406278,1656686,918880,737806,59,66,52
28,10,Khammam,Rural,2142540,1067566,1074974,1172407,662285,510122,55,62,47
28,10,Khammam,Urban,655674,324370,331304,484279,256595,227684,74,79,69
28,11,Srikakulam,Total,2699471,1340430,1359041,1516425,870196,646229,56,65,48
28,11,Srikakulam,Rural,2263124,1125738,1137386,1204000,702392,501608,53,62,44
28,11,Srikakulam,Urban,436347,214692,221655,312425,167804,144621,72,78,65
28,12,Vizianagaram,Total,2342868,1161913,1180955,1256342,720623,535719,54,62,45
28,12,Vizianagaram,Rural,1852446,921155,931291,905741,533687,372054,49,58,40
28,12,Vizianagaram,Urban,490422,240758,249664,350601,186936,163665,71,78,66
28,13,Visakhapatnam,Total,4288113,2140872,2147241,2612624,1450555,1162069,61,68,54
28,13,Visakhapatnam,Rural,2250655,1113637,1137018,1094742,633682,461060,49,57,41
28,13,Visakhapatnam,Urban,2037458,1027235,1010223,1517882,816873,701009,74,80,69
28,14,East Godavari,Total,5151549,2569419,2582130,3324111,1737357,1586754,65,68,61
28,14,East Godavari,Rural,3836952,1920872,1916080,2353639,1237259,1116380,61,64,58
28,14,East Godavari,Urban,1314597,648547,666050,970472,500098,470374,74,77,71
28,15,West Godavari,Total,3934782,1963184,1971598,2654267,1380713,1273554,67,70,65
28,15,West Godavari,Rural,3126191,1565446,1560745,2051923,1073113,978810,66,69,63
28,15,West Godavari,Urban,808591,397738,410853,602344,307600,294744,74,77,72
28,16,Krishna,Total,4529009,2268312,2260697,3065669,1630049,1435620,68,72,64
28,16,Krishna,Rural,2671718,1337414,1334304,1674622,901450,773172,63,67,58
28,16,Krishna,Urban,1857291,930898,926393,1391047,728599,662448,75,78,72
28,17,Guntur,Total,4889230,2441128,2448102,3006999,1660019,1346980,62,68,55
28,17,Guntur,Rural,3232485,1620120,1612365,1824611,1032513,792098,56,64,49
28,17,Guntur,Urban,1656745,821008,835737,1182388,627506,554882,71,76,66
28,18,Prakasam,Total,3392764,1712735,1680029,1926495,1122249,804246,57,66,48
28,18,Prakasam,Rural,2730648,1381772,1348876,1453489,864332,589157,53,63,44
28,18,Prakasam,Urban,662116,330963,331153,473006,257917,215089,71,78,65
28,19,Sri Potti Sriramulu Nellore,Total,2966082,1493254,1472828,1852239,1021639,830600,62,68,56
28,19,Sri Potti Sriramulu Nellore,Rural,2103773,1059330,1044443,1210980,681117,529863,58,64,51
28,19,Sri Potti Sriramulu Nellore,Urban,862309,433924,428385,641259,340522,300737,74,78,70
28,20,Y.S.R.,Total,2884524,1454136,1430388,1745178,1012105,733073,61,70,51
28,20,Y.S.R.,Rural,1900788,959697,941091,1077068,640875,436193,57,67,46
28,20,Y.S.R.,Urban,983736,494439,489297,668110,371230,296880,68,75,61
28,21,Kurnool,Total,4046601,2040101,2006500,2182149,1279938,902211,54,63,45
28,21,Kurnool,Rural,2902877,1466622,1436255,1431527,866938,564589,49,59,39
28,21,Kurnool,Urban,1143724,573479,570245,750622,413000,337622,66,72,59
28,22,Anantapur,Total,4083315,2064928,2018387,2350294,1365701,984593,58,66,49
28,22,Anantapur,Rural,2936359,1489021,1447338,1571487,934968,636519,54,63,44
28,22,Anantapur,Urban,1146956,575907,571049,778807,430733,348074,68,75,61
28,23,Chittoor,Total,4170468,2083505,2086963,2711432,1512958,1198474,65,73,57
28,23,Chittoor,Rural,2941581,1469263,1472318,1788531,1019095,769436,61,69,52
28,23,Chittoor,Urban,1228887,614242,614645,922901,493863,429038,75,80,70
29,0,KARNATAKA,Total,61130704,31057742,30072962,41029323,22808468,18220855,67,73,61
29,0,KARNATAKA,Rural,37552529,19010998,18541531,22860653,13069703,9790950,61,69,53
29,0,KARNATAKA,Urban,23578175,12046744,11531431,18168670,9738765,8429905,77,81,73
29,1,Belgaum,Total,4778439,2427104,2351335,3085292,1752062,1333230,65,72,57
29,1,Belgaum,Rural,3567739,1813926,1753813,2156835,1252523,904312,60,69,52
29,1,Belgaum,Urban,1210700,613178,597522,928457,499539,428918,77,81,72
29,2,Bagalkot,Total,1890826,952902,937924,1128972,654206,474766,60,69,51
29,2,Bagalkot,Rural,1292036,651581,640455,714524,425173,289351,55,65,45
29,2,Bagalkot,Urban,598790,301321,297469,414448,229033,185415,69,76,62
29,3,Bijapur,Total,2175102,1112953,1062149,1257742,739873,517869,58,66,49
29,3,Bijapur,Rural,1674311,859254,815057,900728,545544,355184,54,63,44
29,3,Bijapur,Urban,500791,253699,247092,357014,194329,162685,71,77,66
29,4,Bidar,Total,1700018,870850,829168,1053181,606524,446657,62,70,54
29,4,Bidar,Rural,1276647,652453,624194,745906,436675,309231,58,67,50
29,4,Bidar,Urban,423371,218397,204974,307275,169849,137426,73,78,67
29,5,Raichur,Total,1924773,966493,958280,998899,589746,409153,52,61,43
29,5,Raichur,Rural,1437359,720068,717291,676206,410304,265902,47,57,37
29,5,Raichur,Urban,487414,246425,240989,322693,179442,143251,66,73,59
29,6,Koppal ,Total,1391292,701479,689813,805427,470856,334571,58,67,49
29,6,Koppal ,Rural,1157659,584260,573399,645249,382688,262561,56,65,46
29,6,Koppal ,Urban,233633,117219,116414,160178,88168,72010,69,75,62
29,7,Gadag,Total,1065235,538477,526758,705136,401560,303576,66,75,58
29,7,Gadag,Rural,685450,348298,337152,432324,253418,178906,63,73,53
29,7,Gadag,Urban,379785,190179,189606,272812,148142,124670,72,78,66
29,8,Dharwad,Total,1846993,939127,907866,1314353,721440,592913,71,77,65
29,8,Dharwad,Rural,797430,409828,387602,505173,292105,213068,63,71,55
29,8,Dharwad,Urban,1049563,529299,520264,809180,429335,379845,77,81,73
29,9,Uttara Kannada,Total,1436847,727424,709423,1084277,585127,499150,75,80,70
29,9,Uttara Kannada,Rural,1018216,515867,502349,742234,405314,336920,73,79,67
29,9,Uttara Kannada,Urban,418631,211557,207074,342043,179813,162230,82,85,78
29,10,Haveri,Total,1598506,819295,779211,1094805,608727,486078,68,74,62
29,10,Haveri,Rural,1242442,638485,603957,829126,469721,359405,67,74,60
29,10,Haveri,Urban,356064,180810,175254,265679,139006,126673,75,77,72
29,11,Bellary,Total,2532383,1280402,1251981,1486230,853834,632396,59,67,51
29,11,Bellary,Rural,1613038,817014,796024,867758,513903,353855,54,63,44
29,11,Bellary,Urban,919345,463388,455957,618472,339931,278541,67,73,61
29,12,Chitradurga,Total,1660378,843411,816967,1094403,611462,482941,66,72,59
29,12,Chitradurga,Rural,1332012,678352,653660,839201,476774,362427,63,70,55
29,12,Chitradurga,Urban,328366,165059,163307,255202,134688,120514,78,82,74
29,13,Davanagere ,Total,1946905,989602,957303,1327614,732582,595032,68,74,62
29,13,Davanagere ,Rural,1317816,670545,647271,853226,480508,372718,65,72,58
29,13,Davanagere ,Urban,629089,319057,310032,474388,252074,222314,75,79,72
29,14,Shimoga,Total,1755512,879817,875695,1270845,679895,590950,72,77,67
29,14,Shimoga,Rural,1132286,568041,564245,775428,422170,353258,68,74,63
29,14,Shimoga,Urban,623226,311776,311450,495417,257725,237692,79,83,76
29,15,Udupi,Total,1177908,562896,615012,929623,468933,460690,79,83,75
29,15,Udupi,Rural,843829,399458,444371,647236,326580,320656,77,82,72
29,15,Udupi,Urban,334079,163438,170641,282387,142353,140034,85,87,82
29,16,Chikmagalur,Total,1137753,567483,570270,821670,442110,379560,72,78,67
29,16,Chikmagalur,Rural,898079,448099,449980,630125,342705,287420,70,76,64
29,16,Chikmagalur,Urban,239674,119384,120290,191545,99405,92140,80,83,77
29,17,Tumkur,Total,2681449,1354770,1326679,1805361,1005570,799791,67,74,60
29,17,Tumkur,Rural,2078665,1050056,1028609,1339493,761145,578348,64,72,56
29,17,Tumkur,Urban,602784,304714,298070,465868,244425,221443,77,80,74
29,18,Bangalore,Total,9588910,5025498,4563412,7609962,4146709,3463253,79,83,76
29,18,Bangalore,Rural,868971,464122,404849,608655,352228,256427,70,76,63
29,18,Bangalore,Urban,8719939,4561376,4158563,7001307,3794481,3206826,80,83,77
29,19,Mandya,Total,1808680,909441,899239,1154952,645133,509819,64,71,57
29,19,Mandya,Rural,1499831,755235,744596,922721,522979,399742,62,69,54
29,19,Mandya,Urban,308849,154206,154643,232231,122154,110077,75,79,71
29,20,Hassan,Total,1776221,885807,890414,1229941,673922,556019,69,76,62
29,20,Hassan,Rural,1399214,697310,701904,930847,518819,412028,67,74,59
29,20,Hassan,Urban,377007,188497,188510,299094,155103,143991,79,82,76
29,21,Dakshina Kannada,Total,2083625,1032577,1051048,1666834,866331,800503,80,84,76
29,21,Dakshina Kannada,Rural,1091888,541065,550823,839079,442249,396830,77,82,72
29,21,Dakshina Kannada,Urban,991737,491512,500225,827755,424082,403673,83,86,81
29,22,Kodagu,Total,554762,274725,280037,414305,216413,197892,75,79,71
29,22,Kodagu,Rural,473659,234262,239397,346976,181845,165131,73,78,69
29,22,Kodagu,Urban,81103,40463,40640,67329,34568,32761,83,85,81
29,23,Mysore,Total,2994744,1511206,1483538,1965492,1070649,894843,66,71,60
29,23,Mysore,Rural,1756412,890307,866105,1001558,568283,433275,57,64,50
29,23,Mysore,Urban,1238332,620899,617433,963934,502366,461568,78,81,75
29,24,Chamarajanagar,Total,1020962,513359,507603,566076,315321,250755,55,61,49
29,24,Chamarajanagar,Rural,845669,425680,419989,441521,249199,192322,52,59,46
29,24,Chamarajanagar,Urban,175293,87679,87614,124555,66122,58433,71,75,67
29,25,Gulbarga,Total,2564892,1307061,1257831,1452693,845059,607634,57,65,48
29,25,Gulbarga,Rural,1732298,882029,850269,875080,526797,348283,51,60,41
29,25,Gulbarga,Urban,832594,425032,407562,577613,318262,259351,69,75,64
29,26,Yadgir,Total,1172985,591104,581881,516940,313797,203143,44,53,35
29,26,Yadgir,Rural,952482,479834,472648,378881,236287,142594,40,49,30
29,26,Yadgir,Urban,220503,111270,109233,138059,77510,60549,63,70,55
29,27,Kolar,Total,1540231,779401,760830,1024555,570799,453756,67,73,60
29,27,Kolar,Rural,1056953,536486,520467,654955,376468,278487,62,70,54
29,27,Kolar,Urban,483278,242915,240363,369600,194331,175269,76,80,73
29,28,Chikkballapura,Total,1254377,637504,616873,791692,449291,342401,63,70,56
29,28,Chikkballapura,Rural,975188,496413,478775,587507,340624,246883,60,69,52
29,28,Chikkballapura,Urban,279189,141091,138098,204185,108667,95518,73,77,69
29,29,Bangalore Rural,Total,987257,507514,479743,693068,388833,304235,70,77,63
29,29,Bangalore Rural,Rural,719564,370039,349525,487848,278211,209637,68,75,60
29,29,Bangalore Rural,Urban,267693,137475,130218,205220,110622,94598,77,80,73
29,30,Ramanagara,Total,1082739,548060,534679,678983,381704,297279,63,70,56
29,30,Ramanagara,Rural,815386,412631,402755,484253,278464,205789,59,67,51
29,30,Ramanagara,Urban,267353,135429,131924,194730,103240,91490,73,76,69
30,0,GOA,Total,1457723,740711,717012,1152117,620026,532091,79,84,74
30,0,GOA,Rural,551414,276121,275293,420523,228295,192228,76,83,70
30,0,GOA,Urban,906309,464590,441719,731594,391731,339863,81,84,77
30,1,North Goa,Total,817761,417536,400225,659812,354660,305152,81,85,76
30,1,North Goa,Rural,325041,164397,160644,256195,138588,117607,79,84,73
30,1,North Goa,Urban,492720,253139,239581,403617,216072,187545,82,85,78
30,2,South Goa,Total,639962,323175,316787,492305,265366,226939,77,82,72
30,2,South Goa,Rural,226373,111724,114649,164328,89707,74621,73,80,65
30,2,South Goa,Urban,413589,211451,202138,327977,175659,152318,79,83,75
31,0,LAKSHADWEEP,Total,64429,33106,31323,52914,28249,24665,82,85,79
31,0,LAKSHADWEEP,Rural,14121,7228,6893,11352,5979,5373,80,83,78
31,0,LAKSHADWEEP,Urban,50308,25878,24430,41562,22270,19292,83,86,79
31,1,Lakshadweep,Total,64429,33106,31323,52914,28249,24665,82,85,79
31,1,Lakshadweep,Rural,14121,7228,6893,11352,5979,5373,80,83,78
31,1,Lakshadweep,Urban,50308,25878,24430,41562,22270,19292,83,86,79
32,0,KERALA,Total,33387677,16021290,17366387,28234227,13755888,14478339,85,86,83
32,0,KERALA,Rural,17455506,8403706,9051800,14595727,7158427,7437300,84,85,82
32,0,KERALA,Urban,15932171,7617584,8314587,13638500,6597461,7041039,86,87,85
32,1,Kasaragod,Total,1302600,626617,675983,1036289,517031,519258,80,83,77
32,1,Kasaragod,Rural,797424,387324,410100,629108,318764,310344,79,82,76
32,1,Kasaragod,Urban,505176,239293,265883,407181,198267,208914,81,83,79
32,2,Kannur,Total,2525637,1184012,1341625,2156575,1022972,1133603,85,86,84
32,2,Kannur,Rural,882745,426243,456502,742051,365755,376296,84,86,82
32,2,Kannur,Urban,1642892,757769,885123,1414524,657217,757307,86,87,86
32,3,Wayanad,Total,816558,401314,415244,649186,330093,319093,80,82,77
32,3,Wayanad,Rural,784981,385922,399059,623443,317221,306222,79,82,77
32,3,Wayanad,Urban,31577,15392,16185,25743,12872,12871,82,84,80
32,4,Kozhikode,Total,3089543,1473028,1616515,2634493,1276384,1358109,85,87,84
32,4,Kozhikode,Rural,1014765,485654,529111,856904,418093,438811,84,86,83
32,4,Kozhikode,Urban,2074778,987374,1087404,1777589,858291,919298,86,87,85
32,5,Malappuram,Total,4110956,1961014,2149942,3328658,1608229,1720429,81,82,80
32,5,Malappuram,Rural,2294473,1095465,1199008,1841461,891510,949951,80,81,79
32,5,Malappuram,Urban,1816483,865549,950934,1487197,716719,770478,82,83,81
32,6,Palakkad,Total,2810892,1360067,1450825,2232190,1119360,1112830,79,82,77
32,6,Palakkad,Rural,2133699,1031940,1101759,1667718,838755,828963,78,81,75
32,6,Palakkad,Urban,677193,328127,349066,564472,280605,283867,83,86,81
32,7,Thrissur,Total,3110327,1474665,1635662,2689229,1286141,1403088,86,87,86
32,7,Thrissur,Rural,1020537,485875,534662,868776,419581,449195,85,86,84
32,7,Thrissur,Urban,2089790,988790,1101000,1820453,866560,953893,87,88,87
32,8,Ernakulam,Total,3279860,1617602,1662258,2861509,1427572,1433937,87,88,86
32,8,Ernakulam,Rural,1047296,518040,529256,904606,453707,450899,86,88,85
32,8,Ernakulam,Urban,2232564,1099562,1133002,1956903,973865,983038,88,89,87
32,9,Idukki,Total,1107453,551944,555509,928774,474988,453786,84,86,82
32,9,Idukki,Rural,1055428,526420,529008,883688,452640,431048,84,86,81
32,9,Idukki,Urban,52025,25524,26501,45086,22348,22738,87,88,86
32,10,Kottayam,Total,1979384,970140,1009244,1745694,859038,886656,88,89,88
32,10,Kottayam,Rural,1413773,694308,719465,1256168,619658,636510,89,89,88
32,10,Kottayam,Urban,565611,275832,289779,489526,239380,250146,87,87,86
32,11,Alappuzha,Total,2121943,1010252,1111691,1863558,895476,968082,88,89,87
32,11,Alappuzha,Rural,974916,462571,512345,857351,409806,447545,88,89,87
32,11,Alappuzha,Urban,1147027,547681,599346,1006207,485670,520537,88,89,87
32,12,Pathanamthitta,Total,1195537,561620,633917,1070120,503171,566949,90,90,89
32,12,Pathanamthitta,Rural,1064076,499745,564331,951908,447493,504415,89,90,89
32,12,Pathanamthitta,Urban,131461,61875,69586,118212,55678,62534,90,90,90
32,13,Kollam,Total,2629703,1244815,1384888,2242757,1076509,1166248,85,86,84
32,13,Kollam,Rural,1443363,678969,764394,1235606,588941,646665,86,87,85
32,13,Kollam,Urban,1186340,565846,620494,1007151,487568,519583,85,86,84
32,14,Thiruvananthapuram,Total,3307284,1584200,1723084,2795195,1358924,1436271,85,86,83
32,14,Thiruvananthapuram,Rural,1528030,725230,802800,1276939,616503,660436,84,85,82
32,14,Thiruvananthapuram,Urban,1779254,858970,920284,1518256,742421,775835,85,86,84
33,0,TAMIL NADU,Total,72138958,36158871,35980087,52413116,28314595,24098521,73,78,67
33,0,TAMIL NADU,Rural,37189229,18663701,18525528,24752447,13771878,10980569,67,74,59
33,0,TAMIL NADU,Urban,34949729,17495170,17454559,27660669,14542717,13117952,79,83,75
33,1,Thiruvallur,Total,3725697,1878559,1847138,2812839,1506523,1306316,75,80,71
33,1,Thiruvallur,Rural,1292679,647183,645496,864737,478684,386053,67,74,60
33,1,Thiruvallur,Urban,2433018,1231376,1201642,1948102,1027839,920263,80,83,77
33,2,Chennai,Total,4681087,2357633,2323454,3850472,2004498,1845974,82,85,79
33,2,Chennai,Urban,4681087,2357633,2323454,3850472,2004498,1845974,82,85,79
33,3,Kancheepuram,Total,3990897,2010309,1980588,3065799,1634114,1431685,77,81,72
33,3,Kancheepuram,Rural,1453072,730454,722618,1001425,552540,448885,69,76,62
33,3,Kancheepuram,Urban,2537825,1279855,1257970,2064374,1081574,982800,81,85,78
33,4,Vellore,Total,3928106,1959676,1968430,2804762,1522190,1282572,71,78,65
33,4,Vellore,Rural,2234049,1118058,1115991,1507741,838500,669241,67,75,60
33,4,Vellore,Urban,1694057,841618,852439,1297021,683690,613331,77,81,72
33,5,Tiruvannamalai,Total,2468965,1238688,1230277,1653284,926089,727195,67,75,59
33,5,Tiruvannamalai,Rural,1972622,991393,981229,1280341,727212,553129,65,73,56
33,5,Tiruvannamalai,Urban,496343,247295,249048,372943,198877,174066,75,80,70
33,6,Viluppuram,Total,3463284,1744832,1718452,2223605,1248606,974999,64,72,57
33,6,Viluppuram,Rural,2953408,1489868,1463540,1833783,1040790,792993,62,70,54
33,6,Viluppuram,Urban,509876,254964,254912,389822,207816,182006,76,82,71
33,7,Salem,Total,3480008,1780569,1699439,2311715,1300874,1010841,66,73,59
33,7,Salem,Rural,1703687,880937,822750,1019440,596530,422910,60,68,51
33,7,Salem,Urban,1776321,899632,876689,1292275,704344,587931,73,78,67
33,8,Namakkal,Total,1721179,866740,854439,1184344,659232,525112,69,76,61
33,8,Namakkal,Rural,1028019,519422,508597,678213,384662,293551,66,74,58
33,8,Namakkal,Urban,693160,347318,345842,506131,274570,231561,73,79,67
33,9,Erode,Total,2259608,1134191,1125417,1516380,841728,674652,67,74,60
33,9,Erode,Rural,1102215,557133,545082,671066,384644,286422,61,69,53
33,9,Erode,Urban,1157393,577058,580335,845314,457084,388230,73,79,67
33,10,The Nilgiris,Total,735071,360170,374901,576799,303249,273550,78,84,73
33,10,The Nilgiris,Rural,299061,145518,153543,224620,119873,104747,75,82,68
33,10,The Nilgiris,Urban,436010,214652,221358,352179,183376,168803,81,85,76
33,11,Dindigul,Total,2161367,1081934,1079433,1507310,831243,676067,70,77,63
33,11,Dindigul,Rural,1353808,679755,674053,887063,502100,384963,66,74,57
33,11,Dindigul,Urban,807559,402179,405380,620247,329143,291104,77,82,72
33,12,Karur,Total,1076588,534392,542196,741610,410315,331295,69,77,61
33,12,Karur,Rural,642415,318817,323598,405300,230955,174345,63,72,54
33,12,Karur,Urban,434173,215575,218598,336310,179360,156950,77,83,72
33,13,Tiruchirappalli,Total,2713858,1347863,1365995,2055742,1096125,959617,76,81,70
33,13,Tiruchirappalli,Rural,1377009,684825,692184,959049,528940,430109,70,77,62
33,13,Tiruchirappalli,Urban,1336849,663038,673811,1096693,567185,529508,82,86,79
33,14,Perambalur,Total,564511,281436,283075,379797,210313,169484,67,75,60
33,14,Perambalur,Rural,467726,233390,234336,305376,171235,134141,65,73,57
33,14,Perambalur,Urban,96785,48046,48739,74421,39078,35343,77,81,73
33,15,Ariyalur,Total,752481,373319,379162,486446,273058,213388,65,73,56
33,15,Ariyalur,Rural,668776,331962,336814,424873,240410,184463,64,72,55
33,15,Ariyalur,Urban,83705,41357,42348,61573,32648,28925,74,79,68
33,16,Cuddalore,Total,2600880,1311151,1289729,1849805,1019160,830645,71,78,64
33,16,Cuddalore,Rural,1718249,869252,848997,1152917,649803,503114,67,75,59
33,16,Cuddalore,Urban,882631,441899,440732,696888,369357,327531,79,84,74
33,17,Nagapattinam,Total,1614069,797214,816855,1227311,649255,578056,76,81,71
33,17,Nagapattinam,Rural,1250291,618594,631697,933411,498096,435315,75,81,69
33,17,Nagapattinam,Urban,363778,178620,185158,293900,151159,142741,81,85,77
33,18,Thiruvarur,Total,1268094,627616,640478,960036,510137,449899,76,81,70
33,18,Thiruvarur,Rural,1009411,500543,508868,748568,401896,346672,74,80,68
33,18,Thiruvarur,Urban,258683,127073,131610,211468,108241,103227,82,85,78
33,19,Thanjavur,Total,2402781,1183112,1219669,1802291,951803,850488,75,80,70
33,19,Thanjavur,Rural,1552325,765784,786541,1111132,597444,513688,72,78,65
33,19,Thanjavur,Urban,850456,417328,433128,691159,354359,336800,81,85,78
33,20,Pudukkottai,Total,1618725,803337,815388,1126580,617621,508959,70,77,62
33,20,Pudukkottai,Rural,1304800,646800,658000,874434,485516,388918,67,75,59
33,20,Pudukkottai,Urban,313925,156537,157388,252146,132105,120041,80,84,76
33,21,Sivaganga,Total,1341250,670597,670653,976384,536523,439861,73,80,66
33,21,Sivaganga,Rural,925619,462693,462926,638629,359371,279258,69,78,60
33,21,Sivaganga,Urban,415631,207904,207727,337755,177152,160603,81,85,77
33,22,Madurai,Total,3041038,1528308,1512730,2248749,1194631,1054118,74,78,70
33,22,Madurai,Rural,1196829,604021,592808,758300,416650,341650,63,69,58
33,22,Madurai,Urban,1844209,924287,919922,1490449,777981,712468,81,84,77
33,23,Theni,Total,1243684,624922,618762,879259,485247,394012,71,78,64
33,23,Theni,Rural,574196,290287,283909,379770,215547,164223,66,74,58
33,23,Theni,Urban,669488,334635,334853,499489,269700,229789,75,81,69
33,24,Virudhunagar,Total,1943309,967437,975872,1421270,773186,648084,73,80,66
33,24,Virudhunagar,Rural,963581,480534,483047,664994,370911,294083,69,77,61
33,24,Virudhunagar,Urban,979728,486903,492825,756276,402275,354001,77,83,72
33,25,Ramanathapuram,Total,1337560,676574,660986,986038,537697,448341,74,79,68
33,25,Ramanathapuram,Rural,910949,458962,451987,640290,354049,286241,70,77,63
33,25,Ramanathapuram,Urban,426611,217612,208999,345748,183648,162100,81,84,78
33,26,Thoothukkudi,Total,1738376,858919,879457,1356564,706087,650477,78,82,74
33,26,Thoothukkudi,Rural,866570,427030,439540,645950,341204,304746,75,80,69
33,26,Thoothukkudi,Urban,871806,431889,439917,710614,364883,345731,82,84,79
33,27,Tirunelveli ,Total,3072880,1518595,1554285,2298262,1223964,1074298,75,81,69
33,27,Tirunelveli ,Rural,1552235,765687,786548,1109613,598201,511412,71,78,65
33,27,Tirunelveli ,Urban,1520645,752908,767737,1188649,625763,562886,78,83,73
33,28,Kanniyakumari,Total,1863174,926800,936374,1567580,792385,775195,84,85,83
33,28,Kanniyakumari,Rural,326616,163118,163498,269313,136457,132856,82,84,81
33,28,Kanniyakumari,Urban,1536558,763682,772876,1298267,655928,642339,84,86,83
33,29,Dharmapuri,Total,1502900,772490,730410,867631,475567,392064,58,62,54
33,29,Dharmapuri,Rural,1242519,641575,600944,693480,383581,309899,56,60,52
33,29,Dharmapuri,Urban,260381,130915,129466,174151,91986,82165,67,70,63
33,30,Krishnagiri,Total,1883731,963152,920579,1216436,682852,533584,65,71,58
33,30,Krishnagiri,Rural,1455251,745085,710166,888955,507876,381079,61,68,54
33,30,Krishnagiri,Urban,428480,218067,210413,327481,174976,152505,76,80,72
33,31,Coimbatore,Total,3472578,1735362,1737216,2678637,1418291,1260346,77,82,73
33,31,Coimbatore,Rural,839408,418771,420637,561518,309893,251625,67,74,60
33,31,Coimbatore,Urban,2633170,1316591,1316579,2117119,1108398,1008721,80,84,77
33,32,Tiruppur,Total,2471222,1242974,1228248,1779379,972032,807347,72,78,66
33,32,Tiruppur,Rural,951834,476250,475584,618146,348308,269838,65,73,57
33,32,Tiruppur,Urban,1519388,766724,752664,1161233,623724,537509,76,81,71
34,0,PUDUCHERRY,Total,1244464,610485,633979,966600,502575,464025,78,82,73
34,0,PUDUCHERRY,Rural,394341,194388,199953,284931,152728,132203,72,79,66
34,0,PUDUCHERRY,Urban,850123,416097,434026,681669,349847,331822,80,84,76
34,1,Yanam,Total,55616,27277,28339,39807,20186,19621,72,74,69
34,1,Yanam,Urban,55616,27277,28339,39807,20186,19621,72,74,69
34,2,Puducherry,Total,946600,466143,480457,733075,384551,348524,77,82,73
34,2,Puducherry,Rural,292208,144309,147899,206823,111976,94847,71,78,64
34,2,Puducherry,Urban,654392,321834,332558,526252,272575,253677,80,85,76
34,3,Mahe,Total,41934,19269,22665,36730,16798,19932,88,87,88
34,3,Mahe,Urban,41934,19269,22665,36730,16798,19932,88,87,88
34,4,Karaikal,Total,200314,97796,102518,156988,81040,75948,78,83,74
34,4,Karaikal,Rural,102133,50079,52054,78108,40752,37356,76,81,72
34,4,Karaikal,Urban,98181,47717,50464,78880,40288,38592,80,84,76
35,0,ANDAMAN & NICOBAR ISLANDS,Total,379944,202330,177614,293695,164219,129476,77,81,73
35,0,ANDAMAN & NICOBAR ISLANDS,Rural,244411,130647,113764,183863,103762,80101,75,79,70
35,0,ANDAMAN & NICOBAR ISLANDS,Urban,135533,71683,63850,109832,60457,49375,81,84,77
35,1,Nicobars,Total,36819,20705,16114,25261,15332,9929,69,74,62
35,1,Nicobars,Rural,36819,20705,16114,25261,15332,9929,69,74,62
35,2,North  & Middle Andaman,Total,105539,54821,50718,79108,43414,35694,75,79,70
35,2,North  & Middle Andaman,Rural,102798,53416,49382,77038,42277,34761,75,79,70
35,2,North  & Middle Andaman,Urban,2741,1405,1336,2070,1137,933,76,81,70
35,3,South Andaman,Total,237586,126804,110782,189326,105473,83853,80,83,76
35,3,South Andaman,Rural,104794,56526,48268,81564,46153,35411,78,82,73
35,3,South Andaman,Urban,132792,70278,62514,107762,59320,48442,81,84,77
